bin	mq	FP	total	TP	TP_sum	FP_sum	total_sum	FPR	TPR	mode	breeds	prog	replication
(50,60]	59.9941130355937	32	9936870	9936838	9936838	32	9936870	0.00032	99.36838	pe	BSW	vg	10
(40,50]	46.1669403393541	14	10962	10948	9947786	46	9947832	0.00046	99.47786	pe	BSW	vg	10
(30,40]	35.7588071440275	16	12206	12190	9959976	62	9960038	0.00062	99.59976	pe	BSW	vg	10
(20,30]	24.9212145266918	36	10078	10042	9970018	98	9970116	0.00098	99.70018	pe	BSW	vg	10
(10,20]	16.3889142335766	30	8768	8738	9978756	128	9978884	0.00128	99.78756	pe	BSW	vg	10
[0,10]	2.12208751657511	7187	21116	13929	9992685	7315	10000000	0.07315	99.92685	pe	BSW	vg	10
(50,60]	59.978413489807	45	9719635	9719590	9719590	45	9719635	0.00045	97.1959	se	BSW	vg	10
(40,50]	45.1010746298222	30	40386	40356	9759946	75	9760021	0.00075	97.59946	se	BSW	vg	10
(30,40]	35.9808253180267	40	48345	48305	9808251	115	9808366	0.00115	98.08251	se	BSW	vg	10
(20,30]	24.9627157245794	98	50933	50835	9859086	213	9859299	0.00213	98.59086	se	BSW	vg	10
(10,20]	15.9049794426679	257	41591	41334	9900420	470	9900890	0.0047	99.0042	se	BSW	vg	10
[0,10]	2.76114418323075	31255	99110	67855	9968275	31725	10000000	0.31725	99.68275	se	BSW	vg	10
(50,60]	59.9941140573475	32	9936896	9936864	9936864	32	9936896	0.00032	99.36864	pe	BSW	vg	1
(40,50]	46.1678858814923	14	10936	10922	9947786	46	9947832	0.00046	99.47786	pe	BSW	vg	1
(30,40]	35.7540740740741	16	12150	12134	9959920	62	9959982	0.00062	99.5992	pe	BSW	vg	1
(20,30]	24.9096480822459	36	10116	10080	9970000	98	9970098	0.00098	99.7	pe	BSW	vg	1
(10,20]	16.3825472772841	30	8778	8748	9978748	128	9978876	0.00128	99.78748	pe	BSW	vg	1
[0,10]	2.12431357697406	7182	21124	13942	9992690	7310	10000000	0.0731	99.9269	pe	BSW	vg	1
(50,60]	59.978413489807	45	9719635	9719590	9719590	45	9719635	0.00045	97.1959	se	BSW	vg	1
(40,50]	45.1010746298222	30	40386	40356	9759946	75	9760021	0.00075	97.59946	se	BSW	vg	1
(30,40]	35.9808253180267	40	48345	48305	9808251	115	9808366	0.00115	98.08251	se	BSW	vg	1
(20,30]	24.9627157245794	98	50933	50835	9859086	213	9859299	0.00213	98.59086	se	BSW	vg	1
(10,20]	15.9049794426679	257	41591	41334	9900420	470	9900890	0.0047	99.0042	se	BSW	vg	1
[0,10]	2.76114418323075	31255	99110	67855	9968275	31725	10000000	0.31725	99.68275	se	BSW	vg	1
(50,60]	59.9940999874408	32	9936928	9936896	9936896	32	9936928	0.00032	99.36896	pe	BSW	vg	2
(40,50]	46.1650556264819	14	10966	10952	9947848	46	9947894	0.00046	99.47848	pe	BSW	vg	2
(30,40]	35.7541844437151	16	12188	12172	9960020	62	9960082	0.00062	99.6002	pe	BSW	vg	2
(20,30]	24.9244532803181	36	10060	10024	9970044	98	9970142	0.00098	99.70044	pe	BSW	vg	2
(10,20]	16.3811700182815	30	8752	8722	9978766	128	9978894	0.00128	99.78766	pe	BSW	vg	2
[0,10]	2.12138728323699	7177	21106	13929	9992695	7305	10000000	0.07305	99.92695	pe	BSW	vg	2
(50,60]	59.978413489807	45	9719635	9719590	9719590	45	9719635	0.00045	97.1959	se	BSW	vg	2
(40,50]	45.1010746298222	30	40386	40356	9759946	75	9760021	0.00075	97.59946	se	BSW	vg	2
(30,40]	35.9808253180267	40	48345	48305	9808251	115	9808366	0.00115	98.08251	se	BSW	vg	2
(20,30]	24.9627157245794	98	50933	50835	9859086	213	9859299	0.00213	98.59086	se	BSW	vg	2
(10,20]	15.9049794426679	257	41591	41334	9900420	470	9900890	0.0047	99.0042	se	BSW	vg	2
[0,10]	2.76114418323075	31255	99110	67855	9968275	31725	10000000	0.31725	99.68275	se	BSW	vg	2
(50,60]	59.9941060575535	32	9936982	9936950	9936950	32	9936982	0.00032	99.3695	pe	BSW	vg	3
(40,50]	46.1703839122486	16	10940	10924	9947874	48	9947922	0.00048	99.47874	pe	BSW	vg	3
(30,40]	35.7545961917269	16	12184	12168	9960042	64	9960106	0.00064	99.60042	pe	BSW	vg	3
(20,30]	24.9049520766773	36	10016	9980	9970022	100	9970122	0.001	99.70022	pe	BSW	vg	3
(10,20]	16.3870746745832	30	8758	8728	9978750	130	9978880	0.0013	99.7875	pe	BSW	vg	3
[0,10]	2.12149621212121	7181	21120	13939	9992689	7311	10000000	0.07311	99.92689	pe	BSW	vg	3
(50,60]	59.978413489807	45	9719635	9719590	9719590	45	9719635	0.00045	97.1959	se	BSW	vg	3
(40,50]	45.1010746298222	30	40386	40356	9759946	75	9760021	0.00075	97.59946	se	BSW	vg	3
(30,40]	35.9808253180267	40	48345	48305	9808251	115	9808366	0.00115	98.08251	se	BSW	vg	3
(20,30]	24.9627157245794	98	50933	50835	9859086	213	9859299	0.00213	98.59086	se	BSW	vg	3
(10,20]	15.9049794426679	257	41591	41334	9900420	470	9900890	0.0047	99.0042	se	BSW	vg	3
[0,10]	2.76114418323075	31255	99110	67855	9968275	31725	10000000	0.31725	99.68275	se	BSW	vg	3
(50,60]	59.9941185160675	32	9936948	9936916	9936916	32	9936948	0.00032	99.36916	pe	BSW	vg	4
(40,50]	46.1707272394211	14	10918	10904	9947820	46	9947866	0.00046	99.4782	pe	BSW	vg	4
(30,40]	35.7594083812654	16	12170	12154	9959974	62	9960036	0.00062	99.59974	pe	BSW	vg	4
(20,30]	24.8982916170044	36	10068	10032	9970006	98	9970104	0.00098	99.70006	pe	BSW	vg	4
(10,20]	16.3926618049225	30	8776	8746	9978752	128	9978880	0.00128	99.78752	pe	BSW	vg	4
[0,10]	2.12234848484849	7191	21120	13929	9992681	7319	10000000	0.07319	99.92681	pe	BSW	vg	4
(50,60]	59.978413489807	45	9719635	9719590	9719590	45	9719635	0.00045	97.1959	se	BSW	vg	4
(40,50]	45.1010746298222	30	40386	40356	9759946	75	9760021	0.00075	97.59946	se	BSW	vg	4
(30,40]	35.9808253180267	40	48345	48305	9808251	115	9808366	0.00115	98.08251	se	BSW	vg	4
(20,30]	24.9627157245794	98	50933	50835	9859086	213	9859299	0.00213	98.59086	se	BSW	vg	4
(10,20]	15.9049794426679	257	41591	41334	9900420	470	9900890	0.0047	99.0042	se	BSW	vg	4
[0,10]	2.76114418323075	31255	99110	67855	9968275	31725	10000000	0.31725	99.68275	se	BSW	vg	4
(50,60]	59.994118305328	32	9936932	9936900	9936900	32	9936932	0.00032	99.369	pe	BSW	vg	5
(40,50]	46.1595686346189	14	10942	10928	9947828	46	9947874	0.00046	99.47828	pe	BSW	vg	5
(30,40]	35.7533661740558	16	12180	12164	9959992	62	9960054	0.00062	99.59992	pe	BSW	vg	5
(20,30]	24.9001392480605	36	10054	10018	9970010	98	9970108	0.00098	99.7001	pe	BSW	vg	5
(10,20]	16.3817228805834	30	8776	8746	9978756	128	9978884	0.00128	99.78756	pe	BSW	vg	5
[0,10]	2.12066679295321	7197	21116	13919	9992675	7325	10000000	0.07325	99.92675	pe	BSW	vg	5
(50,60]	59.978413489807	45	9719635	9719590	9719590	45	9719635	0.00045	97.1959	se	BSW	vg	5
(40,50]	45.1010746298222	30	40386	40356	9759946	75	9760021	0.00075	97.59946	se	BSW	vg	5
(30,40]	35.9808253180267	40	48345	48305	9808251	115	9808366	0.00115	98.08251	se	BSW	vg	5
(20,30]	24.9627157245794	98	50933	50835	9859086	213	9859299	0.00213	98.59086	se	BSW	vg	5
(10,20]	15.9049794426679	257	41591	41334	9900420	470	9900890	0.0047	99.0042	se	BSW	vg	5
[0,10]	2.76114418323075	31255	99110	67855	9968275	31725	10000000	0.31725	99.68275	se	BSW	vg	5
(50,60]	59.9941185054136	31	9936930	9936899	9936899	31	9936930	0.00031	99.36899	pe	BSW	vg	6
(40,50]	46.165144318597	16	10948	10932	9947831	47	9947878	0.00047	99.47831	pe	BSW	vg	6
(30,40]	35.7601839684625	16	12176	12160	9959991	63	9960054	0.00063	99.59991	pe	BSW	vg	6
(20,30]	24.900854361216	36	10066	10030	9970021	99	9970120	0.00099	99.70021	pe	BSW	vg	6
(10,20]	16.3774789149761	30	8774	8744	9978765	129	9978894	0.00129	99.78765	pe	BSW	vg	6
[0,10]	2.12110300388515	7191	21106	13915	9992680	7320	10000000	0.0732	99.9268	pe	BSW	vg	6
(50,60]	59.978413489807	45	9719635	9719590	9719590	45	9719635	0.00045	97.1959	se	BSW	vg	6
(40,50]	45.1010746298222	30	40386	40356	9759946	75	9760021	0.00075	97.59946	se	BSW	vg	6
(30,40]	35.9808253180267	40	48345	48305	9808251	115	9808366	0.00115	98.08251	se	BSW	vg	6
(20,30]	24.9627157245794	98	50933	50835	9859086	213	9859299	0.00213	98.59086	se	BSW	vg	6
(10,20]	15.9049794426679	257	41591	41334	9900420	470	9900890	0.0047	99.0042	se	BSW	vg	6
[0,10]	2.76114418323075	31255	99110	67855	9968275	31725	10000000	0.31725	99.68275	se	BSW	vg	6
(50,60]	59.994100411353	32	9936964	9936932	9936932	32	9936964	0.00032	99.36932	pe	BSW	vg	7
(40,50]	46.1679794834219	16	10918	10902	9947834	48	9947882	0.00048	99.47834	pe	BSW	vg	7
(30,40]	35.7617251557888	16	12196	12180	9960014	64	9960078	0.00064	99.60014	pe	BSW	vg	7
(20,30]	24.9193227091633	36	10040	10004	9970018	100	9970118	0.001	99.70018	pe	BSW	vg	7
(10,20]	16.3840893549122	30	8774	8744	9978762	130	9978892	0.0013	99.78762	pe	BSW	vg	7
[0,10]	2.12232328974796	7191	21108	13917	9992679	7321	10000000	0.07321	99.92679	pe	BSW	vg	7
(50,60]	59.978413489807	45	9719635	9719590	9719590	45	9719635	0.00045	97.1959	se	BSW	vg	7
(40,50]	45.1010746298222	30	40386	40356	9759946	75	9760021	0.00075	97.59946	se	BSW	vg	7
(30,40]	35.9808253180267	40	48345	48305	9808251	115	9808366	0.00115	98.08251	se	BSW	vg	7
(20,30]	24.9627157245794	98	50933	50835	9859086	213	9859299	0.00213	98.59086	se	BSW	vg	7
(10,20]	15.9049794426679	257	41591	41334	9900420	470	9900890	0.0047	99.0042	se	BSW	vg	7
[0,10]	2.76114418323075	31255	99110	67855	9968275	31725	10000000	0.31725	99.68275	se	BSW	vg	7
(50,60]	59.9941158782527	32	9936912	9936880	9936880	32	9936912	0.00032	99.3688	pe	BSW	vg	8
(40,50]	46.1588836191171	14	10964	10950	9947830	46	9947876	0.00046	99.4783	pe	BSW	vg	8
(30,40]	35.7622802694266	16	12174	12158	9959988	62	9960050	0.00062	99.59988	pe	BSW	vg	8
(20,30]	24.9149571798447	36	10042	10006	9969994	98	9970092	0.00098	99.69994	pe	BSW	vg	8
(10,20]	16.3892816419612	30	8770	8740	9978734	128	9978862	0.00128	99.78734	pe	BSW	vg	8
[0,10]	2.12252814835841	7177	21138	13961	9992695	7305	10000000	0.07305	99.92695	pe	BSW	vg	8
(50,60]	59.978413489807	45	9719635	9719590	9719590	45	9719635	0.00045	97.1959	se	BSW	vg	8
(40,50]	45.1010746298222	30	40386	40356	9759946	75	9760021	0.00075	97.59946	se	BSW	vg	8
(30,40]	35.9808253180267	40	48345	48305	9808251	115	9808366	0.00115	98.08251	se	BSW	vg	8
(20,30]	24.9627157245794	98	50933	50835	9859086	213	9859299	0.00213	98.59086	se	BSW	vg	8
(10,20]	15.9049794426679	257	41591	41334	9900420	470	9900890	0.0047	99.0042	se	BSW	vg	8
[0,10]	2.76114418323075	31255	99110	67855	9968275	31725	10000000	0.31725	99.68275	se	BSW	vg	8
(50,60]	59.9941257369246	32	9936906	9936874	9936874	32	9936906	0.00032	99.36874	pe	BSW	vg	9
(40,50]	46.163898521628	14	10958	10944	9947818	46	9947864	0.00046	99.47818	pe	BSW	vg	9
(30,40]	35.7643763387708	16	12138	12122	9959940	62	9960002	0.00062	99.5994	pe	BSW	vg	9
(20,30]	24.9062623860484	36	10092	10056	9969996	98	9970094	0.00098	99.69996	pe	BSW	vg	9
(10,20]	16.37787389028	30	8786	8756	9978752	128	9978880	0.00128	99.78752	pe	BSW	vg	9
[0,10]	2.12348484848485	7170	21120	13950	9992702	7298	10000000	0.07298	99.92702	pe	BSW	vg	9
(50,60]	59.978413489807	45	9719635	9719590	9719590	45	9719635	0.00045	97.1959	se	BSW	vg	9
(40,50]	45.1010746298222	30	40386	40356	9759946	75	9760021	0.00075	97.59946	se	BSW	vg	9
(30,40]	35.9808253180267	40	48345	48305	9808251	115	9808366	0.00115	98.08251	se	BSW	vg	9
(20,30]	24.9627157245794	98	50933	50835	9859086	213	9859299	0.00213	98.59086	se	BSW	vg	9
(10,20]	15.9049794426679	257	41591	41334	9900420	470	9900890	0.0047	99.0042	se	BSW	vg	9
[0,10]	2.76114418323075	31255	99110	67855	9968275	31725	10000000	0.31725	99.68275	se	BSW	vg	9
(50,60]	59.9849762057656	819	9857430	9856611	9856611	819	9857430	0.00818922284275222	98.5567569637641	pe	bwa	bwa	10
(40,50]	45.8177466118266	132	59324	59192	9915803	951	9916754	0.00950909758663903	99.1486207958865	pe	bwa	bwa	10
(30,40]	39.7489949189947	281	58453	58172	9973975	1232	9975207	0.0123188309429435	99.7302855958969	pe	bwa	bwa	10
(20,30]	25.3212105468243	527	7699	7172	9981147	1759	9982906	0.0175883308674007	99.8019987903148	pe	bwa	bwa	10
(10,20]	16.5484515484515	323	2002	1679	9982826	2082	9984908	0.0208180243694873	99.818787197095	pe	bwa	bwa	10
[0,10]	0.732497973941774	8703	16041	7338	9990164	10785	10000949	0.107839766006206	99.8921602339938	pe	bwa	bwa	10
(50,60]	59.9701182852782	678	9608719	9608041	9608041	678	9608719	0.0067793464710002	96.0711487412613	se	bwa	bwa	10
(40,50]	45.1693048372811	112	69998	69886	9677927	790	9678717	0.00789923851340731	96.7699413776512	se	bwa	bwa	10
(30,40]	34.9320107253901	151	70114	69963	9747890	941	9748831	0.00940909296343832	97.4695039398202	se	bwa	bwa	10
(20,30]	25.1740830636462	532	66744	66212	9814102	1473	9815575	0.0147285801648721	98.1315601176047	se	bwa	bwa	10
(10,20]	18.1381421001406	1085	46235	45150	9859252	2558	9861810	0.025577534325691	98.5830165972	se	bwa	bwa	10
[0,10]	2.70207108670969	49833	139154	89321	9948573	52391	10000964	0.523859499944205	99.4761405000558	se	bwa	bwa	10
(50,60]	59.9849762057656	819	9857430	9856611	9856611	819	9857430	0.00818922284275222	98.5567569637641	pe	bwa	bwa	1
(40,50]	45.8177466118266	132	59324	59192	9915803	951	9916754	0.00950909758663903	99.1486207958865	pe	bwa	bwa	1
(30,40]	39.7489949189947	281	58453	58172	9973975	1232	9975207	0.0123188309429435	99.7302855958969	pe	bwa	bwa	1
(20,30]	25.3212105468243	527	7699	7172	9981147	1759	9982906	0.0175883308674007	99.8019987903148	pe	bwa	bwa	1
(10,20]	16.5484515484515	323	2002	1679	9982826	2082	9984908	0.0208180243694873	99.818787197095	pe	bwa	bwa	1
[0,10]	0.732497973941774	8703	16041	7338	9990164	10785	10000949	0.107839766006206	99.8921602339938	pe	bwa	bwa	1
(50,60]	59.9701182852782	678	9608719	9608041	9608041	678	9608719	0.0067793464710002	96.0711487412613	se	bwa	bwa	1
(40,50]	45.1693048372811	112	69998	69886	9677927	790	9678717	0.00789923851340731	96.7699413776512	se	bwa	bwa	1
(30,40]	34.9320107253901	151	70114	69963	9747890	941	9748831	0.00940909296343832	97.4695039398202	se	bwa	bwa	1
(20,30]	25.1740830636462	532	66744	66212	9814102	1473	9815575	0.0147285801648721	98.1315601176047	se	bwa	bwa	1
(10,20]	18.1381421001406	1085	46235	45150	9859252	2558	9861810	0.025577534325691	98.5830165972	se	bwa	bwa	1
[0,10]	2.70207108670969	49833	139154	89321	9948573	52391	10000964	0.523859499944205	99.4761405000558	se	bwa	bwa	1
(50,60]	59.9849762057656	819	9857430	9856611	9856611	819	9857430	0.00818922284275222	98.5567569637641	pe	bwa	bwa	2
(40,50]	45.8177466118266	132	59324	59192	9915803	951	9916754	0.00950909758663903	99.1486207958865	pe	bwa	bwa	2
(30,40]	39.7489949189947	281	58453	58172	9973975	1232	9975207	0.0123188309429435	99.7302855958969	pe	bwa	bwa	2
(20,30]	25.3212105468243	527	7699	7172	9981147	1759	9982906	0.0175883308674007	99.8019987903148	pe	bwa	bwa	2
(10,20]	16.5484515484515	323	2002	1679	9982826	2082	9984908	0.0208180243694873	99.818787197095	pe	bwa	bwa	2
[0,10]	0.732497973941774	8703	16041	7338	9990164	10785	10000949	0.107839766006206	99.8921602339938	pe	bwa	bwa	2
(50,60]	59.9701182852782	678	9608719	9608041	9608041	678	9608719	0.0067793464710002	96.0711487412613	se	bwa	bwa	2
(40,50]	45.1693048372811	112	69998	69886	9677927	790	9678717	0.00789923851340731	96.7699413776512	se	bwa	bwa	2
(30,40]	34.9320107253901	151	70114	69963	9747890	941	9748831	0.00940909296343832	97.4695039398202	se	bwa	bwa	2
(20,30]	25.1740830636462	532	66744	66212	9814102	1473	9815575	0.0147285801648721	98.1315601176047	se	bwa	bwa	2
(10,20]	18.1381421001406	1085	46235	45150	9859252	2558	9861810	0.025577534325691	98.5830165972	se	bwa	bwa	2
[0,10]	2.70207108670969	49833	139154	89321	9948573	52391	10000964	0.523859499944205	99.4761405000558	se	bwa	bwa	2
(50,60]	59.9849762057656	819	9857430	9856611	9856611	819	9857430	0.00818922284275222	98.5567569637641	pe	bwa	bwa	3
(40,50]	45.8177466118266	132	59324	59192	9915803	951	9916754	0.00950909758663903	99.1486207958865	pe	bwa	bwa	3
(30,40]	39.7489949189947	281	58453	58172	9973975	1232	9975207	0.0123188309429435	99.7302855958969	pe	bwa	bwa	3
(20,30]	25.3212105468243	527	7699	7172	9981147	1759	9982906	0.0175883308674007	99.8019987903148	pe	bwa	bwa	3
(10,20]	16.5484515484515	323	2002	1679	9982826	2082	9984908	0.0208180243694873	99.818787197095	pe	bwa	bwa	3
[0,10]	0.732497973941774	8703	16041	7338	9990164	10785	10000949	0.107839766006206	99.8921602339938	pe	bwa	bwa	3
(50,60]	59.9701182852782	678	9608719	9608041	9608041	678	9608719	0.0067793464710002	96.0711487412613	se	bwa	bwa	3
(40,50]	45.1693048372811	112	69998	69886	9677927	790	9678717	0.00789923851340731	96.7699413776512	se	bwa	bwa	3
(30,40]	34.9320107253901	151	70114	69963	9747890	941	9748831	0.00940909296343832	97.4695039398202	se	bwa	bwa	3
(20,30]	25.1740830636462	532	66744	66212	9814102	1473	9815575	0.0147285801648721	98.1315601176047	se	bwa	bwa	3
(10,20]	18.1381421001406	1085	46235	45150	9859252	2558	9861810	0.025577534325691	98.5830165972	se	bwa	bwa	3
[0,10]	2.70207108670969	49833	139154	89321	9948573	52391	10000964	0.523859499944205	99.4761405000558	se	bwa	bwa	3
(50,60]	59.9849762057656	819	9857430	9856611	9856611	819	9857430	0.00818922284275222	98.5567569637641	pe	bwa	bwa	4
(40,50]	45.8177466118266	132	59324	59192	9915803	951	9916754	0.00950909758663903	99.1486207958865	pe	bwa	bwa	4
(30,40]	39.7489949189947	281	58453	58172	9973975	1232	9975207	0.0123188309429435	99.7302855958969	pe	bwa	bwa	4
(20,30]	25.3212105468243	527	7699	7172	9981147	1759	9982906	0.0175883308674007	99.8019987903148	pe	bwa	bwa	4
(10,20]	16.5484515484515	323	2002	1679	9982826	2082	9984908	0.0208180243694873	99.818787197095	pe	bwa	bwa	4
[0,10]	0.732497973941774	8703	16041	7338	9990164	10785	10000949	0.107839766006206	99.8921602339938	pe	bwa	bwa	4
(50,60]	59.9701182852782	678	9608719	9608041	9608041	678	9608719	0.0067793464710002	96.0711487412613	se	bwa	bwa	4
(40,50]	45.1693048372811	112	69998	69886	9677927	790	9678717	0.00789923851340731	96.7699413776512	se	bwa	bwa	4
(30,40]	34.9320107253901	151	70114	69963	9747890	941	9748831	0.00940909296343832	97.4695039398202	se	bwa	bwa	4
(20,30]	25.1740830636462	532	66744	66212	9814102	1473	9815575	0.0147285801648721	98.1315601176047	se	bwa	bwa	4
(10,20]	18.1381421001406	1085	46235	45150	9859252	2558	9861810	0.025577534325691	98.5830165972	se	bwa	bwa	4
[0,10]	2.70207108670969	49833	139154	89321	9948573	52391	10000964	0.523859499944205	99.4761405000558	se	bwa	bwa	4
(50,60]	59.9849762057656	819	9857430	9856611	9856611	819	9857430	0.00818922284275222	98.5567569637641	pe	bwa	bwa	5
(40,50]	45.8177466118266	132	59324	59192	9915803	951	9916754	0.00950909758663903	99.1486207958865	pe	bwa	bwa	5
(30,40]	39.7489949189947	281	58453	58172	9973975	1232	9975207	0.0123188309429435	99.7302855958969	pe	bwa	bwa	5
(20,30]	25.3212105468243	527	7699	7172	9981147	1759	9982906	0.0175883308674007	99.8019987903148	pe	bwa	bwa	5
(10,20]	16.5484515484515	323	2002	1679	9982826	2082	9984908	0.0208180243694873	99.818787197095	pe	bwa	bwa	5
[0,10]	0.732497973941774	8703	16041	7338	9990164	10785	10000949	0.107839766006206	99.8921602339938	pe	bwa	bwa	5
(50,60]	59.9701182852782	678	9608719	9608041	9608041	678	9608719	0.0067793464710002	96.0711487412613	se	bwa	bwa	5
(40,50]	45.1693048372811	112	69998	69886	9677927	790	9678717	0.00789923851340731	96.7699413776512	se	bwa	bwa	5
(30,40]	34.9320107253901	151	70114	69963	9747890	941	9748831	0.00940909296343832	97.4695039398202	se	bwa	bwa	5
(20,30]	25.1740830636462	532	66744	66212	9814102	1473	9815575	0.0147285801648721	98.1315601176047	se	bwa	bwa	5
(10,20]	18.1381421001406	1085	46235	45150	9859252	2558	9861810	0.025577534325691	98.5830165972	se	bwa	bwa	5
[0,10]	2.70207108670969	49833	139154	89321	9948573	52391	10000964	0.523859499944205	99.4761405000558	se	bwa	bwa	5
(50,60]	59.9849762057656	819	9857430	9856611	9856611	819	9857430	0.00818922284275222	98.5567569637641	pe	bwa	bwa	6
(40,50]	45.8177466118266	132	59324	59192	9915803	951	9916754	0.00950909758663903	99.1486207958865	pe	bwa	bwa	6
(30,40]	39.7489949189947	281	58453	58172	9973975	1232	9975207	0.0123188309429435	99.7302855958969	pe	bwa	bwa	6
(20,30]	25.3212105468243	527	7699	7172	9981147	1759	9982906	0.0175883308674007	99.8019987903148	pe	bwa	bwa	6
(10,20]	16.5484515484515	323	2002	1679	9982826	2082	9984908	0.0208180243694873	99.818787197095	pe	bwa	bwa	6
[0,10]	0.732497973941774	8703	16041	7338	9990164	10785	10000949	0.107839766006206	99.8921602339938	pe	bwa	bwa	6
(50,60]	59.9701182852782	678	9608719	9608041	9608041	678	9608719	0.0067793464710002	96.0711487412613	se	bwa	bwa	6
(40,50]	45.1693048372811	112	69998	69886	9677927	790	9678717	0.00789923851340731	96.7699413776512	se	bwa	bwa	6
(30,40]	34.9320107253901	151	70114	69963	9747890	941	9748831	0.00940909296343832	97.4695039398202	se	bwa	bwa	6
(20,30]	25.1740830636462	532	66744	66212	9814102	1473	9815575	0.0147285801648721	98.1315601176047	se	bwa	bwa	6
(10,20]	18.1381421001406	1085	46235	45150	9859252	2558	9861810	0.025577534325691	98.5830165972	se	bwa	bwa	6
[0,10]	2.70207108670969	49833	139154	89321	9948573	52391	10000964	0.523859499944205	99.4761405000558	se	bwa	bwa	6
(50,60]	59.9849762057656	819	9857430	9856611	9856611	819	9857430	0.00818922284275222	98.5567569637641	pe	bwa	bwa	7
(40,50]	45.8177466118266	132	59324	59192	9915803	951	9916754	0.00950909758663903	99.1486207958865	pe	bwa	bwa	7
(30,40]	39.7489949189947	281	58453	58172	9973975	1232	9975207	0.0123188309429435	99.7302855958969	pe	bwa	bwa	7
(20,30]	25.3212105468243	527	7699	7172	9981147	1759	9982906	0.0175883308674007	99.8019987903148	pe	bwa	bwa	7
(10,20]	16.5484515484515	323	2002	1679	9982826	2082	9984908	0.0208180243694873	99.818787197095	pe	bwa	bwa	7
[0,10]	0.732497973941774	8703	16041	7338	9990164	10785	10000949	0.107839766006206	99.8921602339938	pe	bwa	bwa	7
(50,60]	59.9701182852782	678	9608719	9608041	9608041	678	9608719	0.0067793464710002	96.0711487412613	se	bwa	bwa	7
(40,50]	45.1693048372811	112	69998	69886	9677927	790	9678717	0.00789923851340731	96.7699413776512	se	bwa	bwa	7
(30,40]	34.9320107253901	151	70114	69963	9747890	941	9748831	0.00940909296343832	97.4695039398202	se	bwa	bwa	7
(20,30]	25.1740830636462	532	66744	66212	9814102	1473	9815575	0.0147285801648721	98.1315601176047	se	bwa	bwa	7
(10,20]	18.1381421001406	1085	46235	45150	9859252	2558	9861810	0.025577534325691	98.5830165972	se	bwa	bwa	7
[0,10]	2.70207108670969	49833	139154	89321	9948573	52391	10000964	0.523859499944205	99.4761405000558	se	bwa	bwa	7
(50,60]	59.9849762057656	819	9857430	9856611	9856611	819	9857430	0.00818922284275222	98.5567569637641	pe	bwa	bwa	8
(40,50]	45.8177466118266	132	59324	59192	9915803	951	9916754	0.00950909758663903	99.1486207958865	pe	bwa	bwa	8
(30,40]	39.7489949189947	281	58453	58172	9973975	1232	9975207	0.0123188309429435	99.7302855958969	pe	bwa	bwa	8
(20,30]	25.3212105468243	527	7699	7172	9981147	1759	9982906	0.0175883308674007	99.8019987903148	pe	bwa	bwa	8
(10,20]	16.5484515484515	323	2002	1679	9982826	2082	9984908	0.0208180243694873	99.818787197095	pe	bwa	bwa	8
[0,10]	0.732497973941774	8703	16041	7338	9990164	10785	10000949	0.107839766006206	99.8921602339938	pe	bwa	bwa	8
(50,60]	59.9701182852782	678	9608719	9608041	9608041	678	9608719	0.0067793464710002	96.0711487412613	se	bwa	bwa	8
(40,50]	45.1693048372811	112	69998	69886	9677927	790	9678717	0.00789923851340731	96.7699413776512	se	bwa	bwa	8
(30,40]	34.9320107253901	151	70114	69963	9747890	941	9748831	0.00940909296343832	97.4695039398202	se	bwa	bwa	8
(20,30]	25.1740830636462	532	66744	66212	9814102	1473	9815575	0.0147285801648721	98.1315601176047	se	bwa	bwa	8
(10,20]	18.1381421001406	1085	46235	45150	9859252	2558	9861810	0.025577534325691	98.5830165972	se	bwa	bwa	8
[0,10]	2.70207108670969	49833	139154	89321	9948573	52391	10000964	0.523859499944205	99.4761405000558	se	bwa	bwa	8
(50,60]	59.9849762057656	819	9857430	9856611	9856611	819	9857430	0.00818922284275222	98.5567569637641	pe	bwa	bwa	9
(40,50]	45.8177466118266	132	59324	59192	9915803	951	9916754	0.00950909758663903	99.1486207958865	pe	bwa	bwa	9
(30,40]	39.7489949189947	281	58453	58172	9973975	1232	9975207	0.0123188309429435	99.7302855958969	pe	bwa	bwa	9
(20,30]	25.3212105468243	527	7699	7172	9981147	1759	9982906	0.0175883308674007	99.8019987903148	pe	bwa	bwa	9
(10,20]	16.5484515484515	323	2002	1679	9982826	2082	9984908	0.0208180243694873	99.818787197095	pe	bwa	bwa	9
[0,10]	0.732497973941774	8703	16041	7338	9990164	10785	10000949	0.107839766006206	99.8921602339938	pe	bwa	bwa	9
(50,60]	59.9701182852782	678	9608719	9608041	9608041	678	9608719	0.0067793464710002	96.0711487412613	se	bwa	bwa	9
(40,50]	45.1693048372811	112	69998	69886	9677927	790	9678717	0.00789923851340731	96.7699413776512	se	bwa	bwa	9
(30,40]	34.9320107253901	151	70114	69963	9747890	941	9748831	0.00940909296343832	97.4695039398202	se	bwa	bwa	9
(20,30]	25.1740830636462	532	66744	66212	9814102	1473	9815575	0.0147285801648721	98.1315601176047	se	bwa	bwa	9
(10,20]	18.1381421001406	1085	46235	45150	9859252	2558	9861810	0.025577534325691	98.5830165972	se	bwa	bwa	9
[0,10]	2.70207108670969	49833	139154	89321	9948573	52391	10000964	0.523859499944205	99.4761405000558	se	bwa	bwa	9
(50,60]	59.9938778710564	46	9935106	9935060	9935060	46	9935106	0.00046	99.3506	pe	FV	vg	10
(40,50]	46.0928521373511	16	11416	11400	9946460	62	9946522	0.00062	99.4646	pe	FV	vg	10
(30,40]	35.7335645593568	46	12686	12640	9959100	108	9959208	0.00108	99.591	pe	FV	vg	10
(20,30]	24.8553249804229	43	10216	10173	9969273	151	9969424	0.00151	99.69273	pe	FV	vg	10
(10,20]	16.3271416083916	106	9152	9046	9978319	257	9978576	0.00257	99.78319	pe	FV	vg	10
[0,10]	2.1048356982823	7436	21424	13988	9992307	7693	10000000	0.07693	99.92307	pe	FV	vg	10
(50,60]	59.9782918504867	103	9712850	9712747	9712747	103	9712850	0.00103	97.12747	se	FV	vg	10
(40,50]	45.1554406684145	61	40813	40752	9753499	164	9753663	0.00164	97.53499	se	FV	vg	10
(30,40]	35.9470348022186	118	49221	49103	9802602	282	9802884	0.00282	98.02602	se	FV	vg	10
(20,30]	24.9544703435137	172	51439	51267	9853869	454	9854323	0.00454	98.53869	se	FV	vg	10
(10,20]	15.8682139585144	536	42569	42033	9895902	990	9896892	0.0099	98.95902	se	FV	vg	10
[0,10]	2.73421073049618	34240	103108	68868	9964770	35230	10000000	0.3523	99.6477	se	FV	vg	10
(50,60]	59.9939526750168	73	9935302	9935229	9935229	73	9935302	0.00073	99.35229	pe	FV	vg	1
(40,50]	46.1735015772871	30	11412	11382	9946611	103	9946714	0.00103	99.46611	pe	FV	vg	1
(30,40]	35.7079603580563	16	12512	12496	9959107	119	9959226	0.00119	99.59107	pe	FV	vg	1
(20,30]	24.8681469836903	55	10178	10123	9969230	174	9969404	0.00174	99.6923	pe	FV	vg	1
(10,20]	16.3326728313518	129	9084	8955	9978185	303	9978488	0.00303	99.78185	pe	FV	vg	1
[0,10]	2.09390107846783	7500	21512	14012	9992197	7803	10000000	0.07803	99.92197	pe	FV	vg	1
(50,60]	59.9783263501142	103	9712808	9712705	9712705	103	9712808	0.00103	97.12705	se	FV	vg	1
(40,50]	45.1577132441686	52	40599	40547	9753252	155	9753407	0.00155	97.53252	se	FV	vg	1
(30,40]	35.9473309608541	106	49175	49069	9802321	261	9802582	0.00261	98.02321	se	FV	vg	1
(20,30]	24.9528353220102	194	51458	51264	9853585	455	9854040	0.00455	98.53585	se	FV	vg	1
(10,20]	15.8864133117112	645	42549	41904	9895489	1100	9896589	0.011	98.95489	se	FV	vg	1
[0,10]	2.73644970070882	34360	103411	69051	9964540	35460	10000000	0.3546	99.6454	se	FV	vg	1
(50,60]	59.9939319653012	72	9935342	9935270	9935270	72	9935342	0.00072	99.3527	pe	FV	vg	2
(40,50]	46.1594101123596	23	11392	11369	9946639	95	9946734	0.00095	99.46639	pe	FV	vg	2
(30,40]	35.6839237057221	38	12478	12440	9959079	133	9959212	0.00133	99.59079	pe	FV	vg	2
(20,30]	24.9157751410231	49	10282	10233	9969312	182	9969494	0.00182	99.69312	pe	FV	vg	2
(10,20]	16.3175166297118	135	9020	8885	9978197	317	9978514	0.00317	99.78197	pe	FV	vg	2
[0,10]	2.09969282323373	7512	21486	13974	9992171	7829	10000000	0.07829	99.92171	pe	FV	vg	2
(50,60]	59.9781783521998	134	9713107	9712973	9712973	134	9713107	0.00134	97.12973	se	FV	vg	2
(40,50]	45.1652238071815	67	40660	40593	9753566	201	9753767	0.00201	97.53566	se	FV	vg	2
(30,40]	35.9358406628166	104	49003	48899	9802465	305	9802770	0.00305	98.02465	se	FV	vg	2
(20,30]	24.9709716905979	201	51467	51266	9853731	506	9854237	0.00506	98.53731	se	FV	vg	2
(10,20]	15.879094084824	572	42653	42081	9895812	1078	9896890	0.01078	98.95812	se	FV	vg	2
[0,10]	2.73848317331006	34182	103110	68928	9964740	35260	10000000	0.3526	99.6474	se	FV	vg	2
(50,60]	59.9938737734009	61	9934990	9934929	9934929	61	9934990	0.00061	99.34929	pe	FV	vg	3
(40,50]	46.192547660312	26	11540	11514	9946443	87	9946530	0.00087	99.46443	pe	FV	vg	3
(30,40]	35.7465101522843	34	12608	12574	9959017	121	9959138	0.00121	99.59017	pe	FV	vg	3
(20,30]	24.8826180678033	63	10206	10143	9969160	184	9969344	0.00184	99.6916	pe	FV	vg	3
(10,20]	16.3504478916321	115	9154	9039	9978199	299	9978498	0.00299	99.78199	pe	FV	vg	3
[0,10]	2.11636126871919	7547	21502	13955	9992154	7846	10000000	0.07846	99.92154	pe	FV	vg	3
(50,60]	59.978322949251	104	9712622	9712518	9712518	104	9712622	0.00104	97.12518	se	FV	vg	3
(40,50]	45.1637370988699	62	40791	40729	9753247	166	9753413	0.00166	97.53247	se	FV	vg	3
(30,40]	35.9444444444444	101	49032	48931	9802178	267	9802445	0.00267	98.02178	se	FV	vg	3
(20,30]	24.9717762313883	214	51446	51232	9853410	481	9853891	0.00481	98.5341	se	FV	vg	3
(10,20]	15.9049640757675	524	42868	42344	9895754	1005	9896759	0.01005	98.95754	se	FV	vg	3
[0,10]	2.72631996977945	34203	103241	69038	9964792	35208	10000000	0.35208	99.64792	se	FV	vg	3
(50,60]	59.9938761730792	54	9934964	9934910	9934910	54	9934964	0.00054	99.3491	pe	FV	vg	4
(40,50]	46.1727383649991	10	11474	11464	9946374	64	9946438	0.00064	99.46374	pe	FV	vg	4
(30,40]	35.6975939613147	34	12718	12684	9959058	98	9959156	0.00098	99.59058	pe	FV	vg	4
(20,30]	24.9152674736431	57	10244	10187	9969245	155	9969400	0.00155	99.69245	pe	FV	vg	4
(10,20]	16.3039666885821	134	9126	8992	9978237	289	9978526	0.00289	99.78237	pe	FV	vg	4
[0,10]	2.09937598956878	7529	21474	13945	9992182	7818	10000000	0.07818	99.92182	pe	FV	vg	4
(50,60]	59.9781650086428	123	9712667	9712544	9712544	123	9712667	0.00123	97.12544	se	FV	vg	4
(40,50]	45.1890488202997	57	40434	40377	9752921	180	9753101	0.0018	97.52921	se	FV	vg	4
(30,40]	35.9556763113607	104	49319	49215	9802136	284	9802420	0.00284	98.02136	se	FV	vg	4
(20,30]	24.9681713522822	181	51683	51502	9853638	465	9854103	0.00465	98.53638	se	FV	vg	4
(10,20]	15.9020337475719	664	42729	42065	9895703	1129	9896832	0.01129	98.95703	se	FV	vg	4
[0,10]	2.73912453473945	34199	103168	68969	9964672	35328	10000000	0.35328	99.64672	se	FV	vg	4
(50,60]	59.9939534339732	77	9935226	9935149	9935149	77	9935226	0.00077	99.35149	pe	FV	vg	5
(40,50]	46.1647966339411	24	11408	11384	9946533	101	9946634	0.00101	99.46533	pe	FV	vg	5
(30,40]	35.7180918953414	36	12536	12500	9959033	137	9959170	0.00137	99.59033	pe	FV	vg	5
(20,30]	24.9048547475141	47	10258	10211	9969244	184	9969428	0.00184	99.69244	pe	FV	vg	5
(10,20]	16.3665268271142	148	9058	8910	9978154	332	9978486	0.00332	99.78154	pe	FV	vg	5
[0,10]	2.09528678999721	7546	21514	13968	9992122	7878	10000000	0.07878	99.92122	pe	FV	vg	5
(50,60]	59.9781117037076	131	9712999	9712868	9712868	131	9712999	0.00131	97.12868	se	FV	vg	5
(40,50]	45.1631146330659	42	40634	40592	9753460	173	9753633	0.00173	97.5346	se	FV	vg	5
(30,40]	35.9219942066827	107	49022	48915	9802375	280	9802655	0.0028	98.02375	se	FV	vg	5
(20,30]	24.9759804878049	172	51250	51078	9853453	452	9853905	0.00452	98.53453	se	FV	vg	5
(10,20]	15.8761224201965	568	42542	41974	9895427	1020	9896447	0.0102	98.95427	se	FV	vg	5
[0,10]	2.74079939741002	34376	103553	69177	9964604	35396	10000000	0.35396	99.64604	se	FV	vg	5
(50,60]	59.9939234678225	52	9935272	9935220	9935220	52	9935272	0.00052	99.3522	pe	FV	vg	6
(40,50]	46.1490921787709	18	11456	11438	9946658	70	9946728	7e-04	99.46658	pe	FV	vg	6
(30,40]	35.738524849636	40	12636	12596	9959254	110	9959364	0.0011	99.59254	pe	FV	vg	6
(20,30]	24.8883795096671	48	10034	9986	9969240	158	9969398	0.00158	99.6924	pe	FV	vg	6
(10,20]	16.3275747508306	116	9030	8914	9978154	274	9978428	0.00274	99.78154	pe	FV	vg	6
[0,10]	2.11959948080846	7455	21572	14117	9992271	7729	10000000	0.07729	99.92271	pe	FV	vg	6
(50,60]	59.978264005325	111	9712645	9712534	9712534	111	9712645	0.00111	97.12534	se	FV	vg	6
(40,50]	45.1675780387926	46	40781	40735	9753269	157	9753426	0.00157	97.53269	se	FV	vg	6
(30,40]	35.9194377575584	108	49018	48910	9802179	265	9802444	0.00265	98.02179	se	FV	vg	6
(20,30]	24.985850971296	196	51735	51539	9853718	461	9854179	0.00461	98.53718	se	FV	vg	6
(10,20]	15.8894983403564	599	42479	41880	9895598	1060	9896658	0.0106	98.95598	se	FV	vg	6
[0,10]	2.74988871901066	34026	103342	69316	9964914	35086	10000000	0.35086	99.64914	se	FV	vg	6
(50,60]	59.9939232219445	69	9934870	9934801	9934801	69	9934870	0.00069	99.34801	pe	FV	vg	7
(40,50]	46.22808540184	29	11522	11493	9946294	98	9946392	0.00098	99.46294	pe	FV	vg	7
(30,40]	35.7021040974529	36	12642	12606	9958900	134	9959034	0.00134	99.589	pe	FV	vg	7
(20,30]	24.9087217172694	51	10342	10291	9969191	185	9969376	0.00185	99.69191	pe	FV	vg	7
(10,20]	16.3075086805556	116	9216	9100	9978291	301	9978592	0.00301	99.78291	pe	FV	vg	7
[0,10]	2.09846786248132	7461	21408	13947	9992238	7762	10000000	0.07762	99.92238	pe	FV	vg	7
(50,60]	59.9781805317811	117	9712794	9712677	9712677	117	9712794	0.00117	97.12677	se	FV	vg	7
(40,50]	45.200470355242	53	40395	40342	9753019	170	9753189	0.0017	97.53019	se	FV	vg	7
(30,40]	35.9439631671412	109	49521	49412	9802431	279	9802710	0.00279	98.02431	se	FV	vg	7
(20,30]	24.967441769732	216	51262	51046	9853477	495	9853972	0.00495	98.53477	se	FV	vg	7
(10,20]	15.8777697354596	568	42829	42261	9895738	1063	9896801	0.01063	98.95738	se	FV	vg	7
[0,10]	2.74523008943885	34151	103199	69048	9964786	35214	10000000	0.35214	99.64786	se	FV	vg	7
(50,60]	59.9937929222726	62	9935110	9935048	9935048	62	9935110	0.00062	99.35048	pe	FV	vg	8
(40,50]	46.1574171029668	18	11460	11442	9946490	80	9946570	8e-04	99.4649	pe	FV	vg	8
(30,40]	35.7138354869209	40	12692	12652	9959142	120	9959262	0.0012	99.59142	pe	FV	vg	8
(20,30]	24.9144240077444	71	10330	10259	9969401	191	9969592	0.00191	99.69401	pe	FV	vg	8
(10,20]	16.2997752808989	111	8900	8789	9978190	302	9978492	0.00302	99.7819	pe	FV	vg	8
[0,10]	2.09494141714711	7543	21508	13965	9992155	7845	10000000	0.07845	99.92155	pe	FV	vg	8
(50,60]	59.9781852227864	117	9713049	9712932	9712932	117	9713049	0.00117	97.12932	se	FV	vg	8
(40,50]	45.1623617141315	58	40767	40709	9753641	175	9753816	0.00175	97.53641	se	FV	vg	8
(30,40]	35.9333604805049	115	49115	49000	9802641	290	9802931	0.0029	98.02641	se	FV	vg	8
(20,30]	24.9659357946049	221	51491	51270	9853911	511	9854422	0.00511	98.53911	se	FV	vg	8
(10,20]	15.8792799567598	627	42553	41926	9895837	1138	9896975	0.01138	98.95837	se	FV	vg	8
[0,10]	2.73809269594759	34202	103025	68823	9964660	35340	10000000	0.3534	99.6466	se	FV	vg	8
(50,60]	59.9939291809578	65	9935068	9935003	9935003	65	9935068	0.00065	99.35003	pe	FV	vg	9
(40,50]	46.1284134116834	18	11572	11554	9946557	83	9946640	0.00083	99.46557	pe	FV	vg	9
(30,40]	35.7423883893359	30	12678	12648	9959205	113	9959318	0.00113	99.59205	pe	FV	vg	9
(20,30]	24.9030433086227	69	10252	10183	9969388	182	9969570	0.00182	99.69388	pe	FV	vg	9
(10,20]	16.3828848698721	152	9068	8916	9978304	334	9978638	0.00334	99.78304	pe	FV	vg	9
[0,10]	2.07405673626065	7494	21362	13868	9992172	7828	10000000	0.07828	99.92172	pe	FV	vg	9
(50,60]	59.9781758886894	113	9712927	9712814	9712814	113	9712927	0.00113	97.12814	se	FV	vg	9
(40,50]	45.169777493983	58	40718	40660	9753474	171	9753645	0.00171	97.53474	se	FV	vg	9
(30,40]	35.9259906878393	122	49183	49061	9802535	293	9802828	0.00293	98.02535	se	FV	vg	9
(20,30]	24.9686178672563	234	51558	51324	9853859	527	9854386	0.00527	98.53859	se	FV	vg	9
(10,20]	15.909095214416	600	42231	41631	9895490	1127	9896617	0.01127	98.9549	se	FV	vg	9
[0,10]	2.7403248116228	34311	103383	69072	9964562	35438	10000000	0.35438	99.64562	se	FV	vg	9
(50,60]	59.994009175771	67	9934860	9934793	9934793	67	9934860	0.00067	99.34793	pe	HOL	vg	10
(40,50]	46.2284438337341	40	11644	11604	9946397	107	9946504	0.00107	99.46397	pe	HOL	vg	10
(30,40]	35.6371582962492	18	12584	12566	9958963	125	9959088	0.00125	99.58963	pe	HOL	vg	10
(20,30]	24.9315883402736	47	10086	10039	9969002	172	9969174	0.00172	99.69002	pe	HOL	vg	10
(10,20]	16.3647211976568	103	9218	9115	9978117	275	9978392	0.00275	99.78117	pe	HOL	vg	10
[0,10]	2.1533691225472	7477	21608	14131	9992248	7752	10000000	0.07752	99.92248	pe	HOL	vg	10
(50,60]	59.9783698891431	124	9714051	9713927	9713927	124	9714051	0.00124	97.13927	se	HOL	vg	10
(40,50]	45.1660128122362	52	40274	40222	9754149	176	9754325	0.00176	97.54149	se	HOL	vg	10
(30,40]	35.9560939764447	84	48991	48907	9803056	260	9803316	0.0026	98.03056	se	HOL	vg	10
(20,30]	24.9796038093748	201	51137	50936	9853992	461	9854453	0.00461	98.53992	se	HOL	vg	10
(10,20]	15.8873880245167	464	42420	41956	9895948	925	9896873	0.00925	98.95948	se	HOL	vg	10
[0,10]	2.72903313390286	33855	103127	69272	9965220	34780	10000000	0.3478	99.6522	se	HOL	vg	10
(50,60]	59.9940633297171	67	9934862	9934795	9934795	67	9934862	0.00067	99.34795	pe	HOL	vg	1
(40,50]	46.222260391618	42	11644	11602	9946397	109	9946506	0.00109	99.46397	pe	HOL	vg	1
(30,40]	35.6275445292621	22	12576	12554	9958951	131	9959082	0.00131	99.58951	pe	HOL	vg	1
(20,30]	24.9274241522903	45	10086	10041	9968992	176	9969168	0.00176	99.68992	pe	HOL	vg	1
(10,20]	16.345340811044	99	9272	9173	9978165	275	9978440	0.00275	99.78165	pe	HOL	vg	1
[0,10]	2.14582560296846	7488	21560	14072	9992237	7763	10000000	0.07763	99.92237	pe	HOL	vg	1
(50,60]	59.9784344384384	127	9714099	9713972	9713972	127	9714099	0.00127	97.13972	se	HOL	vg	1
(40,50]	45.1576632541497	52	40244	40192	9754164	179	9754343	0.00179	97.54164	se	HOL	vg	1
(30,40]	35.9521440368656	83	49043	48960	9803124	262	9803386	0.00262	98.03124	se	HOL	vg	1
(20,30]	24.9672468137591	189	51079	50890	9854014	451	9854465	0.00451	98.54014	se	HOL	vg	1
(10,20]	15.8905453947832	489	42593	42104	9896118	940	9897058	0.0094	98.96118	se	HOL	vg	1
[0,10]	2.7264867595345	33797	102942	69145	9965263	34737	10000000	0.34737	99.65263	se	HOL	vg	1
(50,60]	59.993999195974	73	9935002	9934929	9934929	73	9935002	0.00073	99.34929	pe	HOL	vg	2
(40,50]	46.2230464033121	36	11594	11558	9946487	109	9946596	0.00109	99.46487	pe	HOL	vg	2
(30,40]	35.6287577540958	22	12574	12552	9959039	131	9959170	0.00131	99.59039	pe	HOL	vg	2
(20,30]	24.9294730514927	55	9982	9927	9968966	186	9969152	0.00186	99.68966	pe	HOL	vg	2
(10,20]	16.3598788141095	111	9242	9131	9978097	297	9978394	0.00297	99.78097	pe	HOL	vg	2
[0,10]	2.15791909654726	7463	21606	14143	9992240	7760	10000000	0.0776	99.9224	pe	HOL	vg	2
(50,60]	59.9783375366203	121	9714223	9714102	9714102	121	9714223	0.00121	97.14102	se	HOL	vg	2
(40,50]	45.1601570264361	47	40248	40201	9754303	168	9754471	0.00168	97.54303	se	HOL	vg	2
(30,40]	35.9588064700596	69	48964	48895	9803198	237	9803435	0.00237	98.03198	se	HOL	vg	2
(20,30]	24.9727461261543	196	51112	50916	9854114	433	9854547	0.00433	98.54114	se	HOL	vg	2
(10,20]	15.8800821646126	479	42354	41875	9895989	912	9896901	0.00912	98.95989	se	HOL	vg	2
[0,10]	2.72647649346744	33912	103099	69187	9965176	34824	10000000	0.34824	99.65176	se	HOL	vg	2
(50,60]	59.994014907673	67	9935018	9934951	9934951	67	9935018	0.00067	99.34951	pe	HOL	vg	3
(40,50]	46.2152574479077	44	11614	11570	9946521	111	9946632	0.00111	99.46521	pe	HOL	vg	3
(30,40]	35.6347562918127	22	12556	12534	9959055	133	9959188	0.00133	99.59055	pe	HOL	vg	3
(20,30]	24.9250249252243	55	10030	9975	9969030	188	9969218	0.00188	99.6903	pe	HOL	vg	3
(10,20]	16.3427952329361	103	9230	9127	9978157	291	9978448	0.00291	99.78157	pe	HOL	vg	3
[0,10]	2.15014847809948	7457	21552	14095	9992252	7748	10000000	0.07748	99.92252	pe	HOL	vg	3
(50,60]	59.9784800775621	126	9714022	9713896	9713896	126	9714022	0.00126	97.13896	se	HOL	vg	3
(40,50]	45.1669554884389	49	40394	40345	9754241	175	9754416	0.00175	97.54241	se	HOL	vg	3
(30,40]	35.9672291913537	78	48946	48868	9803109	253	9803362	0.00253	98.03109	se	HOL	vg	3
(20,30]	24.9946918948564	192	51054	50862	9853971	445	9854416	0.00445	98.53971	se	HOL	vg	3
(10,20]	15.8969489928142	411	42445	42034	9896005	856	9896861	0.00856	98.96005	se	HOL	vg	3
[0,10]	2.72548696419395	33932	103139	69207	9965212	34788	10000000	0.34788	99.65212	se	HOL	vg	3
(50,60]	59.9939947937835	65	9935046	9934981	9934981	65	9935046	0.00065	99.34981	pe	HOL	vg	4
(40,50]	46.2076058772688	40	11570	11530	9946511	105	9946616	0.00105	99.46511	pe	HOL	vg	4
(30,40]	35.6436085431941	22	12548	12526	9959037	127	9959164	0.00127	99.59037	pe	HOL	vg	4
(20,30]	24.9362	45	10000	9955	9968992	172	9969164	0.00172	99.68992	pe	HOL	vg	4
(10,20]	16.3564915327833	109	9212	9103	9978095	281	9978376	0.00281	99.78095	pe	HOL	vg	4
[0,10]	2.14964853866075	7505	21624	14119	9992214	7786	10000000	0.07786	99.92214	pe	HOL	vg	4
(50,60]	59.9783615417961	127	9714047	9713920	9713920	127	9714047	0.00127	97.1392	se	HOL	vg	4
(40,50]	45.1644645340751	49	40264	40215	9754135	176	9754311	0.00176	97.54135	se	HOL	vg	4
(30,40]	35.9585497504838	81	49095	49014	9803149	257	9803406	0.00257	98.03149	se	HOL	vg	4
(20,30]	24.9673678849845	192	51054	50862	9854011	449	9854460	0.00449	98.54011	se	HOL	vg	4
(10,20]	15.8915117793299	447	42235	41788	9895799	896	9896695	0.00896	98.95799	se	HOL	vg	4
[0,10]	2.72668312279173	33884	103305	69421	9965220	34780	10000000	0.3478	99.6522	se	HOL	vg	4
(50,60]	59.9940409817634	72	9934858	9934786	9934786	72	9934858	0.00072	99.34786	pe	HOL	vg	5
(40,50]	46.1939684715559	40	11672	11632	9946418	112	9946530	0.00112	99.46418	pe	HOL	vg	5
(30,40]	35.6205962059621	22	12546	12524	9958942	134	9959076	0.00134	99.58942	pe	HOL	vg	5
(20,30]	24.9221604447975	58	10072	10014	9968956	192	9969148	0.00192	99.68956	pe	HOL	vg	5
(10,20]	16.3230669825544	129	9286	9157	9978113	321	9978434	0.00321	99.78113	pe	HOL	vg	5
[0,10]	2.1590466475007	7414	21566	14152	9992265	7735	10000000	0.07735	99.92265	pe	HOL	vg	5
(50,60]	59.9783983981367	133	9714187	9714054	9714054	133	9714187	0.00133	97.14054	se	HOL	vg	5
(40,50]	45.163274976308	48	40098	40050	9754104	181	9754285	0.00181	97.54104	se	HOL	vg	5
(30,40]	35.9627556336446	77	48947	48870	9802974	258	9803232	0.00258	98.02974	se	HOL	vg	5
(20,30]	24.9759392313867	212	51079	50867	9853841	470	9854311	0.0047	98.53841	se	HOL	vg	5
(10,20]	15.8845276451636	461	42521	42060	9895901	931	9896832	0.00931	98.95901	se	HOL	vg	5
[0,10]	2.73020704094293	33889	103168	69279	9965180	34820	10000000	0.3482	99.6518	se	HOL	vg	5
(50,60]	59.993999033323	73	9935066	9934993	9934993	73	9935066	0.00073	99.34993	pe	HOL	vg	6
(40,50]	46.1895661157025	36	11616	11580	9946573	109	9946682	0.00109	99.46573	pe	HOL	vg	6
(30,40]	35.6384108090719	24	12434	12410	9958983	133	9959116	0.00133	99.58983	pe	HOL	vg	6
(20,30]	24.9376237623762	45	10100	10055	9969038	178	9969216	0.00178	99.69038	pe	HOL	vg	6
(10,20]	16.3679389312977	101	9170	9069	9978107	279	9978386	0.00279	99.78107	pe	HOL	vg	6
[0,10]	2.15647265661146	7480	21614	14134	9992241	7759	10000000	0.07759	99.92241	pe	HOL	vg	6
(50,60]	59.9785035816384	123	9714409	9714286	9714286	123	9714409	0.00123	97.14286	se	HOL	vg	6
(40,50]	45.1498775752479	50	40433	40383	9754669	173	9754842	0.00173	97.54669	se	HOL	vg	6
(30,40]	35.9546601045832	87	48765	48678	9803347	260	9803607	0.0026	98.03347	se	HOL	vg	6
(20,30]	24.9850521414177	185	51111	50926	9854273	445	9854718	0.00445	98.54273	se	HOL	vg	6
(10,20]	15.9001873414119	430	42169	41739	9896012	875	9896887	0.00875	98.96012	se	HOL	vg	6
[0,10]	2.73483459893515	33865	103113	69248	9965260	34740	10000000	0.3474	99.6526	se	HOL	vg	6
(50,60]	59.9939987631546	71	9934952	9934881	9934881	71	9934952	0.00071	99.34881	pe	HOL	vg	7
(40,50]	46.2279801607662	38	11694	11656	9946537	109	9946646	0.00109	99.46537	pe	HOL	vg	7
(30,40]	35.6329847144006	22	12430	12408	9958945	131	9959076	0.00131	99.58945	pe	HOL	vg	7
(20,30]	24.9263031755542	43	10014	9971	9968916	174	9969090	0.00174	99.68916	pe	HOL	vg	7
(10,20]	16.3594687232219	153	9336	9183	9978099	327	9978426	0.00327	99.78099	pe	HOL	vg	7
[0,10]	2.1575044034486	7418	21574	14156	9992255	7745	10000000	0.07745	99.92255	pe	HOL	vg	7
(50,60]	59.9785228230906	120	9714219	9714099	9714099	120	9714219	0.0012	97.14099	se	HOL	vg	7
(40,50]	45.1521583178726	53	40425	40372	9754471	173	9754644	0.00173	97.54471	se	HOL	vg	7
(30,40]	35.9579926872355	78	48682	48604	9803075	251	9803326	0.00251	98.03075	se	HOL	vg	7
(20,30]	24.9876907446123	211	51181	50970	9854045	462	9854507	0.00462	98.54045	se	HOL	vg	7
(10,20]	15.8910505836576	510	42405	41895	9895940	972	9896912	0.00972	98.9594	se	HOL	vg	7
[0,10]	2.72953205028713	33742	103088	69346	9965286	34714	10000000	0.34714	99.65286	se	HOL	vg	7
(50,60]	59.993989911587	73	9934962	9934889	9934889	73	9934962	0.00073	99.34889	pe	HOL	vg	8
(40,50]	46.2030412994643	32	11574	11542	9946431	105	9946536	0.00105	99.46431	pe	HOL	vg	8
(30,40]	35.6231212024304	26	12508	12482	9958913	131	9959044	0.00131	99.58913	pe	HOL	vg	8
(20,30]	24.9492896606156	49	10136	10087	9969000	180	9969180	0.0018	99.69	pe	HOL	vg	8
(10,20]	16.3664420778092	103	9202	9099	9978099	283	9978382	0.00283	99.78099	pe	HOL	vg	8
[0,10]	2.15357572393376	7499	21618	14119	9992218	7782	10000000	0.07782	99.92218	pe	HOL	vg	8
(50,60]	59.9785186963395	127	9714308	9714181	9714181	127	9714308	0.00127	97.14181	se	HOL	vg	8
(40,50]	45.1626768091083	50	40227	40177	9754358	177	9754535	0.00177	97.54358	se	HOL	vg	8
(30,40]	35.9760021313222	84	48796	48712	9803070	261	9803331	0.00261	98.0307	se	HOL	vg	8
(20,30]	24.9783126880544	193	51182	50989	9854059	454	9854513	0.00454	98.54059	se	HOL	vg	8
(10,20]	15.8877955089749	444	42173	41729	9895788	898	9896686	0.00898	98.95788	se	HOL	vg	8
[0,10]	2.73003658749056	33929	103314	69385	9965173	34827	10000000	0.34827	99.65173	se	HOL	vg	8
(50,60]	59.9940050278853	66	9934992	9934926	9934926	66	9934992	0.00066	99.34926	pe	HOL	vg	9
(40,50]	46.2031330693751	38	11618	11580	9946506	104	9946610	0.00104	99.46506	pe	HOL	vg	9
(30,40]	35.6123550897253	20	12594	12574	9959080	124	9959204	0.00124	99.5908	pe	HOL	vg	9
(20,30]	24.9206286055301	57	10054	9997	9969077	181	9969258	0.00181	99.69077	pe	HOL	vg	9
(10,20]	16.3594942228036	131	9174	9043	9978120	312	9978432	0.00312	99.7812	pe	HOL	vg	9
[0,10]	2.16162833827893	7459	21568	14109	9992229	7771	10000000	0.07771	99.92229	pe	HOL	vg	9
(50,60]	59.9784431682638	118	9714229	9714111	9714111	118	9714229	0.00118	97.14111	se	HOL	vg	9
(40,50]	45.1745162013399	56	40151	40095	9754206	174	9754380	0.00174	97.54206	se	HOL	vg	9
(30,40]	35.9653537191096	77	48923	48846	9803052	251	9803303	0.00251	98.03052	se	HOL	vg	9
(20,30]	24.9713995666009	251	51223	50972	9854024	502	9854526	0.00502	98.54024	se	HOL	vg	9
(10,20]	15.8826459548148	487	42359	41872	9895896	989	9896885	0.00989	98.95896	se	HOL	vg	9
[0,10]	2.73261892062261	33909	103115	69206	9965102	34898	10000000	0.34898	99.65102	se	HOL	vg	9
(50,60]	59.993893872312	28	9934938	9934910	9934910	28	9934938	0.00028	99.3491	pe	OBV	vg	10
(40,50]	46.1325196163906	20	11470	11450	9946360	48	9946408	0.00048	99.4636	pe	OBV	vg	10
(30,40]	35.7526357199056	12	12710	12698	9959058	60	9959118	6e-04	99.59058	pe	OBV	vg	10
(20,30]	24.8689939203765	44	10198	10154	9969212	104	9969316	0.00104	99.69212	pe	OBV	vg	10
(10,20]	16.4474657385251	101	9194	9093	9978305	205	9978510	0.00205	99.78305	pe	OBV	vg	10
[0,10]	2.08804094927873	7584	21490	13906	9992211	7789	10000000	0.07789	99.92211	pe	OBV	vg	10
(50,60]	59.9783883562277	64	9712866	9712802	9712802	64	9712866	0.00064	97.12802	se	OBV	vg	10
(40,50]	45.1766418713908	53	40868	40815	9753617	117	9753734	0.00117	97.53617	se	OBV	vg	10
(30,40]	35.9572213260368	80	48973	48893	9802510	197	9802707	0.00197	98.0251	se	OBV	vg	10
(20,30]	24.9729651219087	168	51637	51469	9853979	365	9854344	0.00365	98.53979	se	OBV	vg	10
(10,20]	15.8906184559542	524	42978	42454	9896433	889	9897322	0.00889	98.96433	se	OBV	vg	10
[0,10]	2.731792594324	33651	102678	69027	9965460	34540	10000000	0.3454	99.6546	se	OBV	vg	10
(50,60]	59.9939388485443	42	9934416	9934374	9934374	42	9934416	0.00042	99.34374	pe	OBV	vg	1
(40,50]	46.1647914142288	16	11554	11538	9945912	58	9945970	0.00058	99.45912	pe	OBV	vg	1
(30,40]	35.7466392535189	15	12646	12631	9958543	73	9958616	0.00073	99.58543	pe	OBV	vg	1
(20,30]	24.887220939184	45	10392	10347	9968890	118	9969008	0.00118	99.6889	pe	OBV	vg	1
(10,20]	16.4076988515525	139	9404	9265	9978155	257	9978412	0.00257	99.78155	pe	OBV	vg	1
[0,10]	2.10135260329813	7563	21588	14025	9992180	7820	10000000	0.0782	99.9218	pe	OBV	vg	1
(50,60]	59.9785768602498	88	9712862	9712774	9712774	88	9712862	0.00088	97.12774	se	OBV	vg	1
(40,50]	45.1469506103652	50	41041	40991	9753765	138	9753903	0.00138	97.53765	se	OBV	vg	1
(30,40]	35.9226080531954	78	48726	48648	9802413	216	9802629	0.00216	98.02413	se	OBV	vg	1
(20,30]	24.986395088198	166	51305	51139	9853552	382	9853934	0.00382	98.53552	se	OBV	vg	1
(10,20]	15.9060824982522	642	42910	42268	9895820	1024	9896844	0.01024	98.9582	se	OBV	vg	1
[0,10]	2.70720074450347	34011	103156	69145	9964965	35035	10000000	0.35035	99.64965	se	OBV	vg	1
(50,60]	59.9939247492686	33	9934734	9934701	9934701	33	9934734	0.00033	99.34701	pe	OBV	vg	2
(40,50]	46.1547639936831	18	11398	11380	9946081	51	9946132	0.00051	99.46081	pe	OBV	vg	2
(30,40]	35.7012002526848	16	12664	12648	9958729	67	9958796	0.00067	99.58729	pe	OBV	vg	2
(20,30]	24.8498922202626	38	10206	10168	9968897	105	9969002	0.00105	99.68897	pe	OBV	vg	2
(10,20]	16.4064935064935	136	9240	9104	9978001	241	9978242	0.00241	99.78001	pe	OBV	vg	2
[0,10]	2.09568894199835	7671	21758	14087	9992088	7912	10000000	0.07912	99.92088	pe	OBV	vg	2
(50,60]	59.9784089369397	73	9712676	9712603	9712603	73	9712676	0.00073	97.12603	se	OBV	vg	2
(40,50]	45.170583329245	48	40766	40718	9753321	121	9753442	0.00121	97.53321	se	OBV	vg	2
(30,40]	35.9328068043742	77	49380	49303	9802624	198	9802822	0.00198	98.02624	se	OBV	vg	2
(20,30]	24.9651584946908	178	51232	51054	9853678	376	9854054	0.00376	98.53678	se	OBV	vg	2
(10,20]	15.8544409807844	631	42986	42355	9896033	1007	9897040	0.01007	98.96033	se	OBV	vg	2
[0,10]	2.72516511266511	33965	102960	68995	9965028	34972	10000000	0.34972	99.65028	se	OBV	vg	2
(50,60]	59.9938896062508	44	9934548	9934504	9934504	44	9934548	0.00044	99.34504	pe	OBV	vg	3
(40,50]	46.1810928013877	18	11530	11512	9946016	62	9946078	0.00062	99.46016	pe	OBV	vg	3
(30,40]	35.73766851705	26	12610	12584	9958600	88	9958688	0.00088	99.586	pe	OBV	vg	3
(20,30]	24.8833428953911	58	10458	10400	9969000	146	9969146	0.00146	99.69	pe	OBV	vg	3
(10,20]	16.4102397926118	154	9258	9104	9978104	300	9978404	0.003	99.78104	pe	OBV	vg	3
[0,10]	2.06954991665123	7602	21596	13994	9992098	7902	10000000	0.07902	99.92098	pe	OBV	vg	3
(50,60]	59.9784106787653	82	9712209	9712127	9712127	82	9712209	0.00082	97.12127	se	OBV	vg	3
(40,50]	45.1810372412435	51	40627	40576	9752703	133	9752836	0.00133	97.52703	se	OBV	vg	3
(30,40]	35.9328738327202	106	49474	49368	9802071	239	9802310	0.00239	98.02071	se	OBV	vg	3
(20,30]	24.9734230217501	214	51586	51372	9853443	453	9853896	0.00453	98.53443	se	OBV	vg	3
(10,20]	15.87770267142	657	43198	42541	9895984	1110	9897094	0.0111	98.95984	se	OBV	vg	3
[0,10]	2.71509921676093	33736	102906	69170	9965154	34846	10000000	0.34846	99.65154	se	OBV	vg	3
(50,60]	59.9939052070971	49	9934710	9934661	9934661	49	9934710	0.00049	99.34661	pe	OBV	vg	4
(40,50]	46.1698606271777	15	11480	11465	9946126	64	9946190	0.00064	99.46126	pe	OBV	vg	4
(30,40]	35.7583320170589	19	12662	12643	9958769	83	9958852	0.00083	99.58769	pe	OBV	vg	4
(20,30]	24.8833107191316	62	10318	10256	9969025	145	9969170	0.00145	99.69025	pe	OBV	vg	4
(10,20]	16.3932196069963	134	9262	9128	9978153	279	9978432	0.00279	99.78153	pe	OBV	vg	4
[0,10]	2.09894287833828	7496	21568	14072	9992225	7775	10000000	0.07775	99.92225	pe	OBV	vg	4
(50,60]	59.9785167796028	85	9713162	9713077	9713077	85	9713162	0.00085	97.13077	se	OBV	vg	4
(40,50]	45.1562385298652	50	40867	40817	9753894	135	9754029	0.00135	97.53894	se	OBV	vg	4
(30,40]	35.9348632454245	87	49066	48979	9802873	222	9803095	0.00222	98.02873	se	OBV	vg	4
(20,30]	24.9797423523001	175	51388	51213	9854086	397	9854483	0.00397	98.54086	se	OBV	vg	4
(10,20]	15.8797832003536	625	42989	42364	9896450	1022	9897472	0.01022	98.9645	se	OBV	vg	4
[0,10]	2.73879330524345	33672	102528	68856	9965306	34694	10000000	0.34694	99.65306	se	OBV	vg	4
(50,60]	59.9938247048848	32	9934424	9934392	9934392	32	9934424	0.00032	99.34392	pe	OBV	vg	5
(40,50]	46.1515204170287	14	11510	11496	9945888	46	9945934	0.00046	99.45888	pe	OBV	vg	5
(30,40]	35.7042910447761	10	12864	12854	9958742	56	9958798	0.00056	99.58742	pe	OBV	vg	5
(20,30]	24.8789647791399	42	10278	10236	9968978	98	9969076	0.00098	99.68978	pe	OBV	vg	5
(10,20]	16.4122334697394	115	9286	9171	9978149	213	9978362	0.00213	99.78149	pe	OBV	vg	5
[0,10]	2.13152786764026	7492	21638	14146	9992295	7705	10000000	0.07705	99.92295	pe	OBV	vg	5
(50,60]	59.9784350793906	78	9712301	9712223	9712223	78	9712301	0.00078	97.12223	se	OBV	vg	5
(40,50]	45.171048455999	45	40965	40920	9753143	123	9753266	0.00123	97.53143	se	OBV	vg	5
(30,40]	35.9376685462123	76	48948	48872	9802015	199	9802214	0.00199	98.02015	se	OBV	vg	5
(20,30]	24.9623809246648	180	51543	51363	9853378	379	9853757	0.00379	98.53378	se	OBV	vg	5
(10,20]	15.8841324466354	623	43006	42383	9895761	1002	9896763	0.01002	98.95761	se	OBV	vg	5
[0,10]	2.71804682429749	33806	103237	69431	9965192	34808	10000000	0.34808	99.65192	se	OBV	vg	5
(50,60]	59.9939439364172	26	9934506	9934480	9934480	26	9934506	0.00026	99.3448	pe	OBV	vg	6
(40,50]	46.192882929345	22	11634	11612	9946092	48	9946140	0.00048	99.46092	pe	OBV	vg	6
(30,40]	35.7226196153235	19	12582	12563	9958655	67	9958722	0.00067	99.58655	pe	OBV	vg	6
(20,30]	24.910707307542	42	10236	10194	9968849	109	9968958	0.00109	99.68849	pe	OBV	vg	6
(10,20]	16.4398455929659	130	9326	9196	9978045	239	9978284	0.00239	99.78045	pe	OBV	vg	6
[0,10]	2.11070178670105	7677	21716	14039	9992084	7916	10000000	0.07916	99.92084	pe	OBV	vg	6
(50,60]	59.9783325221393	51	9712021	9711970	9711970	51	9712021	0.00051	97.1197	se	OBV	vg	6
(40,50]	45.1766444395594	42	40941	40899	9752869	93	9752962	0.00093	97.52869	se	OBV	vg	6
(30,40]	35.9258166276585	77	49135	49058	9801927	170	9802097	0.0017	98.01927	se	OBV	vg	6
(20,30]	24.9785233858619	207	51591	51384	9853311	377	9853688	0.00377	98.53311	se	OBV	vg	6
(10,20]	15.9118881118881	608	42900	42292	9895603	985	9896588	0.00985	98.95603	se	OBV	vg	6
[0,10]	2.71991645070205	34190	103412	69222	9964825	35175	10000000	0.35175	99.64825	se	OBV	vg	6
(50,60]	59.9939928574592	26	9934840	9934814	9934814	26	9934840	0.00026	99.34814	pe	OBV	vg	7
(40,50]	46.1542728375802	24	11538	11514	9946328	50	9946378	5e-04	99.46328	pe	OBV	vg	7
(30,40]	35.7183972014629	26	12578	12552	9958880	76	9958956	0.00076	99.5888	pe	OBV	vg	7
(20,30]	24.8803929121726	80	10384	10304	9969184	156	9969340	0.00156	99.69184	pe	OBV	vg	7
(10,20]	16.3972362360167	99	9118	9019	9978203	255	9978458	0.00255	99.78203	pe	OBV	vg	7
[0,10]	2.13675610435428	7482	21542	14060	9992263	7737	10000000	0.07737	99.92263	pe	OBV	vg	7
(50,60]	59.9784289233291	78	9713377	9713299	9713299	78	9713377	0.00078	97.13299	se	OBV	vg	7
(40,50]	45.1613517255018	60	40452	40392	9753691	138	9753829	0.00138	97.53691	se	OBV	vg	7
(30,40]	35.9406340527969	76	49018	48942	9802633	214	9802847	0.00214	98.02633	se	OBV	vg	7
(20,30]	24.9831286851272	167	51389	51222	9853855	381	9854236	0.00381	98.53855	se	OBV	vg	7
(10,20]	15.876605783155	528	42814	42286	9896141	909	9897050	0.00909	98.96141	se	OBV	vg	7
[0,10]	2.72104905293832	33850	102950	69100	9965241	34759	10000000	0.34759	99.65241	se	OBV	vg	7
(50,60]	59.9939397416579	49	9934890	9934841	9934841	49	9934890	0.00049	99.34841	pe	OBV	vg	8
(40,50]	46.1164011902678	8	11426	11418	9946259	57	9946316	0.00057	99.46259	pe	OBV	vg	8
(30,40]	35.7089778344762	20	12542	12522	9958781	77	9958858	0.00077	99.58781	pe	OBV	vg	8
(20,30]	24.8759010325346	58	10266	10208	9968989	135	9969124	0.00135	99.68989	pe	OBV	vg	8
(10,20]	16.3850487540628	125	9230	9105	9978094	260	9978354	0.0026	99.78094	pe	OBV	vg	8
[0,10]	2.10551603067541	7642	21646	14004	9992098	7902	10000000	0.07902	99.92098	pe	OBV	vg	8
(50,60]	59.9783838985356	71	9712806	9712735	9712735	71	9712806	0.00071	97.12735	se	OBV	vg	8
(40,50]	45.1486922512833	59	40910	40851	9753586	130	9753716	0.0013	97.53586	se	OBV	vg	8
(30,40]	35.9217570490064	79	49014	48935	9802521	209	9802730	0.00209	98.02521	se	OBV	vg	8
(20,30]	24.9660201706749	149	51560	51411	9853932	358	9854290	0.00358	98.53932	se	OBV	vg	8
(10,20]	15.8817133905399	560	42769	42209	9896141	918	9897059	0.00918	98.96141	se	OBV	vg	8
[0,10]	2.71009607445041	33890	102941	69051	9965192	34808	10000000	0.34808	99.65192	se	OBV	vg	8
(50,60]	59.9938541697492	24	9934866	9934842	9934842	24	9934866	0.00024	99.34842	pe	OBV	vg	9
(40,50]	46.1756140350877	18	11400	11382	9946224	42	9946266	0.00042	99.46224	pe	OBV	vg	9
(30,40]	35.699213836478	16	12720	12704	9958928	58	9958986	0.00058	99.58928	pe	OBV	vg	9
(20,30]	24.9423228346457	68	10160	10092	9969020	126	9969146	0.00126	99.6902	pe	OBV	vg	9
(10,20]	16.4513064133017	145	9262	9117	9978137	271	9978408	0.00271	99.78137	pe	OBV	vg	9
[0,10]	2.10281585772508	7566	21592	14026	9992163	7837	10000000	0.07837	99.92163	pe	OBV	vg	9
(50,60]	59.9784523138219	67	9712783	9712716	9712716	67	9712783	0.00067	97.12716	se	OBV	vg	9
(40,50]	45.1784244562022	45	40824	40779	9753495	112	9753607	0.00112	97.53495	se	OBV	vg	9
(30,40]	35.9379582858074	92	49096	49004	9802499	204	9802703	0.00204	98.02499	se	OBV	vg	9
(20,30]	24.9767288523446	173	51566	51393	9853892	377	9854269	0.00377	98.53892	se	OBV	vg	9
(10,20]	15.8789080727951	596	42860	42264	9896156	973	9897129	0.00973	98.96156	se	OBV	vg	9
[0,10]	2.73098346472767	33851	102871	69020	9965176	34824	10000000	0.34824	99.65176	se	OBV	vg	9
(50,60]	59.9937432182969	39	9934820	9934781	9934781	39	9934820	0.00039	99.34781	pe	pangenome	vg	10
(40,50]	46.1179228898923	6	11516	11510	9946291	45	9946336	0.00045	99.46291	pe	pangenome	vg	10
(30,40]	35.7367012905257	16	12708	12692	9958983	61	9959044	0.00061	99.58983	pe	pangenome	vg	10
(20,30]	24.8755364806867	57	10252	10195	9969178	118	9969296	0.00118	99.69178	pe	pangenome	vg	10
(10,20]	16.3892748588797	148	9212	9064	9978242	266	9978508	0.00266	99.78242	pe	pangenome	vg	10
[0,10]	2.1358645077238	7471	21492	14021	9992263	7737	10000000	0.07737	99.92263	pe	pangenome	vg	10
(50,60]	59.9779666068982	71	9712485	9712414	9712414	71	9712485	0.00071	97.12414	se	pangenome	vg	10
(40,50]	45.1482660742935	29	40515	40486	9752900	100	9753000	0.001	97.529	se	pangenome	vg	10
(30,40]	35.9799151796431	71	49988	49917	9802817	171	9802988	0.00171	98.02817	se	pangenome	vg	10
(20,30]	24.9618265050087	163	52209	52046	9854863	334	9855197	0.00334	98.54863	se	pangenome	vg	10
(10,20]	15.8687025049254	680	42636	41956	9896819	1014	9897833	0.01014	98.96819	se	pangenome	vg	10
[0,10]	2.7513482827136	33283	102167	68884	9965703	34297	10000000	0.34297	99.65703	se	pangenome	vg	10
(50,60]	59.9939129918379	62	9934930	9934868	9934868	62	9934930	0.00062	99.34868	pe	pangenome	vg	1
(40,50]	46.132250174703	16	11448	11432	9946300	78	9946378	0.00078	99.463	pe	pangenome	vg	1
(30,40]	35.7053261897258	36	12692	12656	9958956	114	9959070	0.00114	99.58956	pe	pangenome	vg	1
(20,30]	24.8983410493827	52	10368	10316	9969272	166	9969438	0.00166	99.69272	pe	pangenome	vg	1
(10,20]	16.3785999113868	95	9028	8933	9978205	261	9978466	0.00261	99.78205	pe	pangenome	vg	1
[0,10]	2.0785734187796	7573	21534	13961	9992166	7834	10000000	0.07834	99.92166	pe	pangenome	vg	1
(50,60]	59.9779163784492	82	9711994	9711912	9711912	82	9711994	0.00082	97.11912	se	pangenome	vg	1
(40,50]	45.1698758145826	40	40665	40625	9752537	122	9752659	0.00122	97.52537	se	pangenome	vg	1
(30,40]	35.9648379153042	49	49542	49493	9802030	171	9802201	0.00171	98.0203	se	pangenome	vg	1
(20,30]	24.9815247761875	138	52611	52473	9854503	309	9854812	0.00309	98.54503	se	pangenome	vg	1
(10,20]	15.8449145418885	532	42828	42296	9896799	841	9897640	0.00841	98.96799	se	pangenome	vg	1
[0,10]	2.75419109026964	33590	102360	68770	9965569	34431	10000000	0.34431	99.65569	se	pangenome	vg	1
(50,60]	59.9938213286559	29	9934822	9934793	9934793	29	9934822	0.00029	99.34793	pe	pangenome	vg	2
(40,50]	46.1037768537769	8	11544	11536	9946329	37	9946366	0.00037	99.46329	pe	pangenome	vg	2
(30,40]	35.7246769819748	20	12538	12518	9958847	57	9958904	0.00057	99.58847	pe	pangenome	vg	2
(20,30]	24.9110210384096	48	10362	10314	9969161	105	9969266	0.00105	99.69161	pe	pangenome	vg	2
(10,20]	16.340874811463	93	9282	9189	9978350	198	9978548	0.00198	99.7835	pe	pangenome	vg	2
[0,10]	2.14749207533097	7362	21452	14090	9992440	7560	10000000	0.0756	99.9244	pe	pangenome	vg	2
(50,60]	59.9779716763398	72	9711951	9711879	9711879	72	9711951	0.00072	97.11879	se	pangenome	vg	2
(40,50]	45.1691763492102	30	40709	40679	9752558	102	9752660	0.00102	97.52558	se	pangenome	vg	2
(30,40]	36.0021413276231	59	49969	49910	9802468	161	9802629	0.00161	98.02468	se	pangenome	vg	2
(20,30]	24.9667774717447	161	52645	52484	9854952	322	9855274	0.00322	98.54952	se	pangenome	vg	2
(10,20]	15.8485019652145	491	42489	41998	9896950	813	9897763	0.00813	98.9695	se	pangenome	vg	2
[0,10]	2.76978002093176	33221	102237	69016	9965966	34034	10000000	0.34034	99.65966	se	pangenome	vg	2
(50,60]	59.9938703537954	54	9934668	9934614	9934614	54	9934668	0.00054	99.34614	pe	pangenome	vg	3
(40,50]	46.1821384534085	8	11354	11346	9945960	62	9946022	0.00062	99.4596	pe	pangenome	vg	3
(30,40]	35.7620383356709	17	12834	12817	9958777	79	9958856	0.00079	99.58777	pe	pangenome	vg	3
(20,30]	24.8747108712413	45	10376	10331	9969108	124	9969232	0.00124	99.69108	pe	pangenome	vg	3
(10,20]	16.3425282363162	125	9208	9083	9978191	249	9978440	0.00249	99.78191	pe	pangenome	vg	3
[0,10]	2.16159554730983	7532	21560	14028	9992219	7781	10000000	0.07781	99.92219	pe	pangenome	vg	3
(50,60]	59.977616763181	83	9712715	9712632	9712632	83	9712715	0.00083	97.12632	se	pangenome	vg	3
(40,50]	45.1694777333925	36	40554	40518	9753150	119	9753269	0.00119	97.5315	se	pangenome	vg	3
(30,40]	35.9618238391575	61	50136	50075	9803225	180	9803405	0.0018	98.03225	se	pangenome	vg	3
(20,30]	24.9582722149309	149	51812	51663	9854888	329	9855217	0.00329	98.54888	se	pangenome	vg	3
(10,20]	15.8647292250233	615	42840	42225	9897113	944	9898057	0.00944	98.97113	se	pangenome	vg	3
[0,10]	2.77112700234445	33112	101943	68831	9965944	34056	10000000	0.34056	99.65944	se	pangenome	vg	3
(50,60]	59.9939398356108	44	9934714	9934670	9934670	44	9934714	0.00044	99.3467	pe	pangenome	vg	4
(40,50]	46.1597355141813	20	11494	11474	9946144	64	9946208	0.00064	99.46144	pe	pangenome	vg	4
(30,40]	35.7572344752073	20	12786	12766	9958910	84	9958994	0.00084	99.5891	pe	pangenome	vg	4
(20,30]	24.8747072599532	40	10248	10208	9969118	124	9969242	0.00124	99.69118	pe	pangenome	vg	4
(10,20]	16.3706293706294	104	9152	9048	9978166	228	9978394	0.00228	99.78166	pe	pangenome	vg	4
[0,10]	2.1057113764695	7517	21606	14089	9992255	7745	10000000	0.07745	99.92255	pe	pangenome	vg	4
(50,60]	59.9778701506556	76	9712086	9712010	9712010	76	9712086	0.00076	97.1201	se	pangenome	vg	4
(40,50]	45.1550106557578	38	40823	40785	9752795	114	9752909	0.00114	97.52795	se	pangenome	vg	4
(30,40]	35.9759846301633	51	49968	49917	9802712	165	9802877	0.00165	98.02712	se	pangenome	vg	4
(20,30]	24.9631562846545	169	52302	52133	9854845	334	9855179	0.00334	98.54845	se	pangenome	vg	4
(10,20]	15.8435768616772	661	42596	41935	9896780	995	9897775	0.00995	98.9678	se	pangenome	vg	4
[0,10]	2.76727806309611	33418	102225	68807	9965587	34413	10000000	0.34413	99.65587	se	pangenome	vg	4
(50,60]	59.9937960522382	38	9934642	9934604	9934604	38	9934642	0.00038	99.34604	pe	pangenome	vg	5
(40,50]	46.1726956521739	10	11500	11490	9946094	48	9946142	0.00048	99.46094	pe	pangenome	vg	5
(30,40]	35.7120202981288	19	12612	12593	9958687	67	9958754	0.00067	99.58687	pe	pangenome	vg	5
(20,30]	24.8946253130418	58	10382	10324	9969011	125	9969136	0.00125	99.69011	pe	pangenome	vg	5
(10,20]	16.3379549393414	146	9232	9086	9978097	271	9978368	0.00271	99.78097	pe	pangenome	vg	5
[0,10]	2.13110207100592	7545	21632	14087	9992184	7816	10000000	0.07816	99.92184	pe	pangenome	vg	5
(50,60]	59.9778790491414	73	9712738	9712665	9712665	73	9712738	0.00073	97.12665	se	pangenome	vg	5
(40,50]	45.1484618814088	41	40374	40333	9752998	114	9753112	0.00114	97.52998	se	pangenome	vg	5
(30,40]	35.9779772928577	75	49676	49601	9802599	189	9802788	0.00189	98.02599	se	pangenome	vg	5
(20,30]	24.9786033882749	153	52298	52145	9854744	342	9855086	0.00342	98.54744	se	pangenome	vg	5
(10,20]	15.8285841391744	550	42709	42159	9896903	892	9897795	0.00892	98.96903	se	pangenome	vg	5
[0,10]	2.75691013159826	33233	102205	68972	9965875	34125	10000000	0.34125	99.65875	se	pangenome	vg	5
(50,60]	59.9938890273456	38	9934916	9934878	9934878	38	9934916	0.00038	99.34878	pe	pangenome	vg	6
(40,50]	46.0725434551259	22	11276	11254	9946132	60	9946192	6e-04	99.46132	pe	pangenome	vg	6
(30,40]	35.7400406186533	24	12802	12778	9958910	84	9958994	0.00084	99.5891	pe	pangenome	vg	6
(20,30]	24.9346743295019	65	10440	10375	9969285	149	9969434	0.00149	99.69285	pe	pangenome	vg	6
(10,20]	16.3620119126406	160	9066	8906	9978191	309	9978500	0.00309	99.78191	pe	pangenome	vg	6
[0,10]	2.16548837209302	7429	21500	14071	9992262	7738	10000000	0.07738	99.92262	pe	pangenome	vg	6
(50,60]	59.9777790201991	61	9712218	9712157	9712157	61	9712218	0.00061	97.12157	se	pangenome	vg	6
(40,50]	45.1355136760285	38	40911	40873	9753030	99	9753129	0.00099	97.5303	se	pangenome	vg	6
(30,40]	35.9406590309789	58	49679	49621	9802651	157	9802808	0.00157	98.02651	se	pangenome	vg	6
(20,30]	24.9644481984144	148	52093	51945	9854596	305	9854901	0.00305	98.54596	se	pangenome	vg	6
(10,20]	15.8346364803361	656	42845	42189	9896785	961	9897746	0.00961	98.96785	se	pangenome	vg	6
[0,10]	2.75146204549455	33423	102254	68831	9965616	34384	10000000	0.34384	99.65616	se	pangenome	vg	6
(50,60]	59.9939038187141	32	9935072	9935040	9935040	32	9935072	0.00032	99.3504	pe	pangenome	vg	7
(40,50]	46.1464753808006	10	11292	11282	9946322	42	9946364	0.00042	99.46322	pe	pangenome	vg	7
(30,40]	35.7396616541353	8	12768	12760	9959082	50	9959132	5e-04	99.59082	pe	pangenome	vg	7
(20,30]	24.884720593982	32	10236	10204	9969286	82	9969368	0.00082	99.69286	pe	pangenome	vg	7
(10,20]	16.28032111087	101	9218	9117	9978403	183	9978586	0.00183	99.78403	pe	pangenome	vg	7
[0,10]	2.17455869991594	7299	21414	14115	9992518	7482	10000000	0.07482	99.92518	pe	pangenome	vg	7
(50,60]	59.9779484263747	61	9712096	9712035	9712035	61	9712096	0.00061	97.12035	se	pangenome	vg	7
(40,50]	45.1366085578447	36	41015	40979	9753014	97	9753111	0.00097	97.53014	se	pangenome	vg	7
(30,40]	35.9556128408587	56	49654	49598	9802612	153	9802765	0.00153	98.02612	se	pangenome	vg	7
(20,30]	24.9534562742016	132	52166	52034	9854646	285	9854931	0.00285	98.54646	se	pangenome	vg	7
(10,20]	15.8600288600289	528	42966	42438	9897084	813	9897897	0.00813	98.97084	se	pangenome	vg	7
[0,10]	2.76830259639775	33236	102103	68867	9965951	34049	10000000	0.34049	99.65951	se	pangenome	vg	7
(50,60]	59.9939181580385	45	9935148	9935103	9935103	45	9935148	0.00045	99.35103	pe	pangenome	vg	8
(40,50]	46.1249780277729	14	11378	11364	9946467	59	9946526	0.00059	99.46467	pe	pangenome	vg	8
(30,40]	35.7587684494525	13	12602	12589	9959056	72	9959128	0.00072	99.59056	pe	pangenome	vg	8
(20,30]	24.8568346734654	70	10198	10128	9969184	142	9969326	0.00142	99.69184	pe	pangenome	vg	8
(10,20]	16.3259883344135	123	9258	9135	9978319	265	9978584	0.00265	99.78319	pe	pangenome	vg	8
[0,10]	2.11636159880463	7491	21416	13925	9992244	7756	10000000	0.07756	99.92244	pe	pangenome	vg	8
(50,60]	59.9780011263522	71	9712770	9712699	9712699	71	9712770	0.00071	97.12699	se	pangenome	vg	8
(40,50]	45.1797947322864	39	40435	40396	9753095	110	9753205	0.0011	97.53095	se	pangenome	vg	8
(30,40]	35.9932221063608	44	49868	49824	9802919	154	9803073	0.00154	98.02919	se	pangenome	vg	8
(20,30]	24.9657062894167	143	52167	52024	9854943	297	9855240	0.00297	98.54943	se	pangenome	vg	8
(10,20]	15.8405005369566	616	42834	42218	9897161	913	9898074	0.00913	98.97161	se	pangenome	vg	8
[0,10]	2.75931558189275	33231	101926	68695	9965856	34144	10000000	0.34144	99.65856	se	pangenome	vg	8
(50,60]	59.9938572349162	55	9934614	9934559	9934559	55	9934614	0.00055	99.34559	pe	pangenome	vg	9
(40,50]	46.152132945006	10	11674	11664	9946223	65	9946288	0.00065	99.46223	pe	pangenome	vg	9
(30,40]	35.7576807940759	10	12694	12684	9958907	75	9958982	0.00075	99.58907	pe	pangenome	vg	9
(20,30]	24.8419310881838	73	10274	10201	9969108	148	9969256	0.00148	99.69108	pe	pangenome	vg	9
(10,20]	16.3237019335216	151	9206	9055	9978163	299	9978462	0.00299	99.78163	pe	pangenome	vg	9
[0,10]	2.12675271612963	7453	21538	14085	9992248	7752	10000000	0.07752	99.92248	pe	pangenome	vg	9
(50,60]	59.9778930240321	71	9711957	9711886	9711886	71	9711957	0.00071	97.11886	se	pangenome	vg	9
(40,50]	45.1401623162974	30	41031	41001	9752887	101	9752988	0.00101	97.52887	se	pangenome	vg	9
(30,40]	35.9530441461837	49	49472	49423	9802310	150	9802460	0.0015	98.0231	se	pangenome	vg	9
(20,30]	24.9611038307409	190	52653	52463	9854773	340	9855113	0.0034	98.54773	se	pangenome	vg	9
(10,20]	15.8285059192363	629	42742	42113	9896886	969	9897855	0.00969	98.96886	se	pangenome	vg	9
[0,10]	2.75914631161584	33306	102145	68839	9965725	34275	10000000	0.34275	99.65725	se	pangenome	vg	9
(50,60]	59.9937048973396	114	9924858	9924744	9924744	114	9924858	0.00114	99.24744	pe	random	vg	10
(40,50]	46.42834279063	60	13746	13686	9938430	174	9938604	0.00174	99.3843	pe	random	vg	10
(30,40]	35.5789329685363	70	14620	14550	9952980	244	9953224	0.00244	99.5298	pe	random	vg	10
(20,30]	24.9424534803584	158	11608	11450	9964430	402	9964832	0.00402	99.6443	pe	random	vg	10
(10,20]	16.4799640610961	452	11130	10678	9975108	854	9975962	0.00854	99.75108	pe	random	vg	10
[0,10]	2.01364506198519	8775	24038	15263	9990371	9629	10000000	0.09629	99.90371	pe	random	vg	10
(50,60]	59.9763885836905	212	9693150	9692938	9692938	212	9693150	0.00212	96.92938	se	random	vg	10
(40,50]	45.0093573902704	123	38686	38563	9731501	335	9731836	0.00335	97.31501	se	random	vg	10
(30,40]	36.1858343624268	185	50206	50021	9781522	520	9782042	0.0052	97.81522	se	random	vg	10
(20,30]	24.7900831024931	690	54150	53460	9834982	1210	9836192	0.0121	98.34982	se	random	vg	10
(10,20]	15.9513760393489	1723	42695	40972	9875954	2933	9878887	0.02933	98.75954	se	random	vg	10
[0,10]	2.66028419740243	48499	121113	72614	9948568	51432	10000000	0.51432	99.48568	se	random	vg	10
(50,60]	59.9937925122431	130	9924788	9924658	9924658	130	9924788	0.0013	99.24658	pe	random	vg	1
(40,50]	46.4546244029527	66	13818	13752	9938410	196	9938606	0.00196	99.3841	pe	random	vg	1
(30,40]	35.5970927043335	67	14584	14517	9952927	263	9953190	0.00263	99.52927	pe	random	vg	1
(20,30]	24.9272790535839	164	11496	11332	9964259	427	9964686	0.00427	99.64259	pe	random	vg	1
(10,20]	16.4520621317622	440	11202	10762	9975021	867	9975888	0.00867	99.75021	pe	random	vg	1
[0,10]	2.01003649635036	8819	24112	15293	9990314	9686	10000000	0.09686	99.90314	pe	random	vg	1
(50,60]	59.9763639728647	229	9693338	9693109	9693109	229	9693338	0.00229	96.93109	se	random	vg	1
(40,50]	44.9960827771049	119	38803	38684	9731793	348	9732141	0.00348	97.31793	se	random	vg	1
(30,40]	36.178135073825	169	50254	50085	9781878	517	9782395	0.00517	97.81878	se	random	vg	1
(20,30]	24.7946328048578	693	54181	53488	9835366	1210	9836576	0.0121	98.35366	se	random	vg	1
(10,20]	15.9626304409138	1750	42548	40798	9876164	2960	9879124	0.0296	98.76164	se	random	vg	1
[0,10]	2.65683841291902	48369	120876	72507	9948671	51329	10000000	0.51329	99.48671	se	random	vg	1
(50,60]	59.9937487846482	118	9925110	9924992	9924992	118	9925110	0.00118	99.24992	pe	random	vg	2
(40,50]	46.4152330539627	57	13602	13545	9938537	175	9938712	0.00175	99.38537	pe	random	vg	2
(30,40]	35.5802197802198	56	14560	14504	9953041	231	9953272	0.00231	99.53041	pe	random	vg	2
(20,30]	24.9290792747956	154	11252	11098	9964139	385	9964524	0.00385	99.64139	pe	random	vg	2
(10,20]	16.4349593495935	488	11316	10828	9974967	873	9975840	0.00873	99.74967	pe	random	vg	2
[0,10]	2.02723509933775	8853	24160	15307	9990274	9726	10000000	0.09726	99.90274	pe	random	vg	2
(50,60]	59.976332294934	222	9693124	9692902	9692902	222	9693124	0.00222	96.92902	se	random	vg	2
(40,50]	45.0006157003592	90	38980	38890	9731792	312	9732104	0.00312	97.31792	se	random	vg	2
(30,40]	36.1855919174171	180	50083	49903	9781695	492	9782187	0.00492	97.81695	se	random	vg	2
(20,30]	24.7941078807556	732	54208	53476	9835171	1224	9836395	0.01224	98.35171	se	random	vg	2
(10,20]	15.9625216942633	1805	42638	40833	9876004	3029	9879033	0.03029	98.76004	se	random	vg	2
[0,10]	2.66598328469748	48460	120967	72507	9948511	51489	10000000	0.51489	99.48511	se	random	vg	2
(50,60]	59.9937593552241	135	9924936	9924801	9924801	135	9924936	0.00135	99.24801	pe	random	vg	3
(40,50]	46.492660011744	82	13624	13542	9938343	217	9938560	0.00217	99.38343	pe	random	vg	3
(30,40]	35.5985580193171	55	14702	14647	9952990	272	9953262	0.00272	99.5299	pe	random	vg	3
(20,30]	24.9566122874002	177	11524	11347	9964337	449	9964786	0.00449	99.64337	pe	random	vg	3
(10,20]	16.4768235716852	431	11132	10701	9975038	880	9975918	0.0088	99.75038	pe	random	vg	3
[0,10]	2.03305373307865	8826	24082	15256	9990294	9706	10000000	0.09706	99.90294	pe	random	vg	3
(50,60]	59.9762901384901	223	9693688	9693465	9693465	223	9693688	0.00223	96.93465	se	random	vg	3
(40,50]	45.0034050456586	111	38766	38655	9732120	334	9732454	0.00334	97.3212	se	random	vg	3
(30,40]	36.1837681736706	198	50210	50012	9782132	532	9782664	0.00532	97.82132	se	random	vg	3
(20,30]	24.806159353434	746	54194	53448	9835580	1278	9836858	0.01278	98.3558	se	random	vg	3
(10,20]	15.9653732051738	1709	42135	40426	9876006	2987	9878993	0.02987	98.76006	se	random	vg	3
[0,10]	2.65772228052923	48470	121007	72537	9948543	51457	10000000	0.51457	99.48543	se	random	vg	3
(50,60]	59.9937525692592	125	9925040	9924915	9924915	125	9925040	0.00125	99.24915	pe	random	vg	4
(40,50]	46.4461291733489	70	13718	13648	9938563	195	9938758	0.00195	99.38563	pe	random	vg	4
(30,40]	35.5878804496847	70	14588	14518	9953081	265	9953346	0.00265	99.53081	pe	random	vg	4
(20,30]	24.9042405283281	142	11508	11366	9964447	407	9964854	0.00407	99.64447	pe	random	vg	4
(10,20]	16.4797988866942	426	11138	10712	9975159	833	9975992	0.00833	99.75159	pe	random	vg	4
[0,10]	2.02082639120293	8841	24008	15167	9990326	9674	10000000	0.09674	99.90326	pe	random	vg	4
(50,60]	59.9762402371324	221	9693489	9693268	9693268	221	9693489	0.00221	96.93268	se	random	vg	4
(40,50]	45.0075540033631	99	38655	38556	9731824	320	9732144	0.0032	97.31824	se	random	vg	4
(30,40]	36.1779034795945	160	50207	50047	9781871	480	9782351	0.0048	97.81871	se	random	vg	4
(20,30]	24.8076160763443	682	54490	53808	9835679	1162	9836841	0.01162	98.35679	se	random	vg	4
(10,20]	15.9581511261579	1791	42534	40743	9876422	2953	9879375	0.02953	98.76422	se	random	vg	4
[0,10]	2.66707564766839	48359	120625	72266	9948688	51312	10000000	0.51312	99.48688	se	random	vg	4
(50,60]	59.9936699231577	115	9924998	9924883	9924883	115	9924998	0.00115	99.24883	pe	random	vg	5
(40,50]	46.4664808566818	78	13634	13556	9938439	193	9938632	0.00193	99.38439	pe	random	vg	5
(30,40]	35.5696375034069	63	14676	14613	9953052	256	9953308	0.00256	99.53052	pe	random	vg	5
(20,30]	24.9150201084106	139	11438	11299	9964351	395	9964746	0.00395	99.64351	pe	random	vg	5
(10,20]	16.450053514092	451	11212	10761	9975112	846	9975958	0.00846	99.75112	pe	random	vg	5
[0,10]	2.03843274270027	8796	24042	15246	9990358	9642	10000000	0.09642	99.90358	pe	random	vg	5
(50,60]	59.9763709902472	223	9693085	9692862	9692862	223	9693085	0.00223	96.92862	se	random	vg	5
(40,50]	45.0044519218325	88	38635	38547	9731409	311	9731720	0.00311	97.31409	se	random	vg	5
(30,40]	36.1871079170968	171	50372	50201	9781610	482	9782092	0.00482	97.8161	se	random	vg	5
(20,30]	24.8074277095137	684	54364	53680	9835290	1166	9836456	0.01166	98.3529	se	random	vg	5
(10,20]	15.9577081131854	1751	42585	40834	9876124	2917	9879041	0.02917	98.76124	se	random	vg	5
[0,10]	2.66464669846808	48373	120959	72586	9948710	51290	10000000	0.5129	99.4871	se	random	vg	5
(50,60]	59.993747270766	128	9924946	9924818	9924818	128	9924946	0.00128	99.24818	pe	random	vg	6
(40,50]	46.431878113097	65	13652	13587	9938405	193	9938598	0.00193	99.38405	pe	random	vg	6
(30,40]	35.5650334379692	57	14654	14597	9953002	250	9953252	0.0025	99.53002	pe	random	vg	6
(20,30]	24.9040763226366	152	11530	11378	9964380	402	9964782	0.00402	99.6438	pe	random	vg	6
(10,20]	16.4185629815445	503	11162	10659	9975039	905	9975944	0.00905	99.75039	pe	random	vg	6
[0,10]	2.02086797472564	8787	24056	15269	9990308	9692	10000000	0.09692	99.90308	pe	random	vg	6
(50,60]	59.9762881166371	228	9693241	9693013	9693013	228	9693241	0.00228	96.93013	se	random	vg	6
(40,50]	44.9987143224479	106	38890	38784	9731797	334	9732131	0.00334	97.31797	se	random	vg	6
(30,40]	36.1820522030651	166	50112	49946	9781743	500	9782243	0.005	97.81743	se	random	vg	6
(20,30]	24.7975863657301	692	54275	53583	9835326	1192	9836518	0.01192	98.35326	se	random	vg	6
(10,20]	15.9435255585449	1793	42745	40952	9876278	2985	9879263	0.02985	98.76278	se	random	vg	6
[0,10]	2.66567829248698	48352	120737	72385	9948663	51337	10000000	0.51337	99.48663	se	random	vg	6
(50,60]	59.9936576816653	128	9924762	9924634	9924634	128	9924762	0.00128	99.24634	pe	random	vg	7
(40,50]	46.4305434466725	56	13764	13708	9938342	184	9938526	0.00184	99.38342	pe	random	vg	7
(30,40]	35.5805258833196	39	14604	14565	9952907	223	9953130	0.00223	99.52907	pe	random	vg	7
(20,30]	24.908353469106	157	11588	11431	9964338	380	9964718	0.0038	99.64338	pe	random	vg	7
(10,20]	16.4869549678342	453	11192	10739	9975077	833	9975910	0.00833	99.75077	pe	random	vg	7
[0,10]	2.04948111249481	8821	24090	15269	9990346	9654	10000000	0.09654	99.90346	pe	random	vg	7
(50,60]	59.9761809383751	214	9693245	9693031	9693031	214	9693245	0.00214	96.93031	se	random	vg	7
(40,50]	45.0077708874765	98	38863	38765	9731796	312	9732108	0.00312	97.31796	se	random	vg	7
(30,40]	36.1865884559366	163	50121	49958	9781754	475	9782229	0.00475	97.81754	se	random	vg	7
(20,30]	24.8021919322159	678	54290	53612	9835366	1153	9836519	0.01153	98.35366	se	random	vg	7
(10,20]	15.9702972629199	1758	42454	40696	9876062	2911	9878973	0.02911	98.76062	se	random	vg	7
[0,10]	2.65926611417287	48457	121027	72570	9948632	51368	10000000	0.51368	99.48632	se	random	vg	7
(50,60]	59.9936342157628	114	9925250	9925136	9925136	114	9925250	0.00114	99.25136	pe	random	vg	8
(40,50]	46.465191740413	56	13560	13504	9938640	170	9938810	0.0017	99.3864	pe	random	vg	8
(30,40]	35.6015646828723	58	14316	14258	9952898	228	9953126	0.00228	99.52898	pe	random	vg	8
(20,30]	24.9481829247087	166	11502	11336	9964234	394	9964628	0.00394	99.64234	pe	random	vg	8
(10,20]	16.4294336943014	480	11266	10786	9975020	874	9975894	0.00874	99.7502	pe	random	vg	8
[0,10]	2.03625653364308	8803	24106	15303	9990323	9677	10000000	0.09677	99.90323	pe	random	vg	8
(50,60]	59.9763351842066	209	9693082	9692873	9692873	209	9693082	0.00209	96.92873	se	random	vg	8
(40,50]	44.9907218886111	119	38801	38682	9731555	328	9731883	0.00328	97.31555	se	random	vg	8
(30,40]	36.192430469654	194	50122	49928	9781483	522	9782005	0.00522	97.81483	se	random	vg	8
(20,30]	24.7964185251236	714	54391	53677	9835160	1236	9836396	0.01236	98.3516	se	random	vg	8
(10,20]	15.9525366719611	1737	42812	41075	9876235	2973	9879208	0.02973	98.76235	se	random	vg	8
[0,10]	2.66121100735148	48312	120792	72480	9948715	51285	10000000	0.51285	99.48715	se	random	vg	8
(50,60]	59.9937531171442	134	9924950	9924816	9924816	134	9924950	0.00134	99.24816	pe	random	vg	9
(40,50]	46.3932257595581	55	13758	13703	9938519	189	9938708	0.00189	99.38519	pe	random	vg	9
(30,40]	35.5693007860985	59	14502	14443	9952962	248	9953210	0.00248	99.52962	pe	random	vg	9
(20,30]	24.9466154919749	164	11464	11300	9964262	412	9964674	0.00412	99.64262	pe	random	vg	9
(10,20]	16.5334412081985	472	11124	10652	9974914	884	9975798	0.00884	99.74914	pe	random	vg	9
[0,10]	2.01983307164697	8925	24202	15277	9990191	9809	10000000	0.09809	99.90191	pe	random	vg	9
(50,60]	59.9763485143285	234	9693260	9693026	9693026	234	9693260	0.00234	96.93026	se	random	vg	9
(40,50]	45.0098809616432	96	38559	38463	9731489	330	9731819	0.0033	97.31489	se	random	vg	9
(30,40]	36.1768737299279	163	50194	50031	9781520	493	9782013	0.00493	97.8152	se	random	vg	9
(20,30]	24.8047393888102	634	54353	53719	9835239	1127	9836366	0.01127	98.35239	se	random	vg	9
(10,20]	15.9568572100682	1837	42510	40673	9875912	2964	9878876	0.02964	98.75912	se	random	vg	9
[0,10]	2.65854826458836	48528	121124	72596	9948508	51492	10000000	0.51492	99.48508	se	random	vg	9
(50,60]	59.9937906384227	129	9925336	9925207	9925207	129	9925336	0.00129	99.25207	pe	vgref	vgref	10
(40,50]	46.4305010893246	69	13770	13701	9938908	198	9939106	0.00198	99.38908	pe	vgref	vgref	10
(30,40]	35.5650628758885	61	14632	14571	9953479	259	9953738	0.00259	99.53479	pe	vgref	vgref	10
(20,30]	24.9517667844523	133	11320	11187	9964666	392	9965058	0.00392	99.64666	pe	vgref	vgref	10
(10,20]	16.5454213123743	399	10942	10543	9975209	791	9976000	0.00791	99.75209	pe	vgref	vgref	10
[0,10]	1.99491666666667	8863	24000	15137	9990346	9654	10000000	0.09654	99.90346	pe	vgref	vgref	10
(50,60]	59.9764417223985	214	9694342	9694128	9694128	214	9694342	0.00214	96.94128	se	vgref	vgref	10
(40,50]	45.0523109243697	86	38080	37994	9732122	300	9732422	0.003	97.32122	se	vgref	vgref	10
(30,40]	36.1945534546319	198	50454	50256	9782378	498	9782876	0.00498	97.82378	se	vgref	vgref	10
(20,30]	24.7925509278961	671	54047	53376	9835754	1169	9836923	0.01169	98.35754	se	vgref	vgref	10
(10,20]	15.9588908096332	1711	42229	40518	9876272	2880	9879152	0.0288	98.76272	se	vgref	vgref	10
[0,10]	2.65819045412419	48484	120848	72364	9948636	51364	10000000	0.51364	99.48636	se	vgref	vgref	10
(50,60]	59.9937978775881	127	9925312	9925185	9925185	127	9925312	0.00127	99.25185	pe	vgref	vgref	1
(40,50]	46.4293801712876	69	13778	13709	9938894	196	9939090	0.00196	99.38894	pe	vgref	vgref	1
(30,40]	35.56613828915	61	14636	14575	9953469	257	9953726	0.00257	99.53469	pe	vgref	vgref	1
(20,30]	24.9544169611307	133	11320	11187	9964656	390	9965046	0.0039	99.64656	pe	vgref	vgref	1
(10,20]	16.5433789954338	399	10950	10551	9975207	789	9975996	0.00789	99.75207	pe	vgref	vgref	1
[0,10]	1.9971671388102	8869	24004	15135	9990342	9658	10000000	0.09658	99.90342	pe	vgref	vgref	1
(50,60]	59.9764417223985	214	9694342	9694128	9694128	214	9694342	0.00214	96.94128	se	vgref	vgref	1
(40,50]	45.0523109243697	86	38080	37994	9732122	300	9732422	0.003	97.32122	se	vgref	vgref	1
(30,40]	36.1945534546319	198	50454	50256	9782378	498	9782876	0.00498	97.82378	se	vgref	vgref	1
(20,30]	24.7925509278961	671	54047	53376	9835754	1169	9836923	0.01169	98.35754	se	vgref	vgref	1
(10,20]	15.9588908096332	1711	42229	40518	9876272	2880	9879152	0.0288	98.76272	se	vgref	vgref	1
[0,10]	2.65819045412419	48484	120848	72364	9948636	51364	10000000	0.51364	99.48636	se	vgref	vgref	1
(50,60]	59.9938033257151	129	9925324	9925195	9925195	129	9925324	0.00129	99.25195	pe	vgref	vgref	2
(40,50]	46.4310595065312	69	13780	13711	9938906	198	9939104	0.00198	99.38906	pe	vgref	vgref	2
(30,40]	35.5678000819336	61	14646	14585	9953491	259	9953750	0.00259	99.53491	pe	vgref	vgref	2
(20,30]	24.9515644334453	133	11314	11181	9964672	392	9965064	0.00392	99.64672	pe	vgref	vgref	2
(10,20]	16.5439912200476	399	10934	10535	9975207	791	9975998	0.00791	99.75207	pe	vgref	vgref	2
[0,10]	1.99658361803183	8868	24002	15134	9990341	9659	10000000	0.09659	99.90341	pe	vgref	vgref	2
(50,60]	59.9764417223985	214	9694342	9694128	9694128	214	9694342	0.00214	96.94128	se	vgref	vgref	2
(40,50]	45.0523109243697	86	38080	37994	9732122	300	9732422	0.003	97.32122	se	vgref	vgref	2
(30,40]	36.1945534546319	198	50454	50256	9782378	498	9782876	0.00498	97.82378	se	vgref	vgref	2
(20,30]	24.7925509278961	671	54047	53376	9835754	1169	9836923	0.01169	98.35754	se	vgref	vgref	2
(10,20]	15.9588908096332	1711	42229	40518	9876272	2880	9879152	0.0288	98.76272	se	vgref	vgref	2
[0,10]	2.65819045412419	48484	120848	72364	9948636	51364	10000000	0.51364	99.48636	se	vgref	vgref	2
(50,60]	59.9938005096454	129	9925332	9925203	9925203	129	9925332	0.00129	99.25203	pe	vgref	vgref	3
(40,50]	46.4315804764672	69	13768	13699	9938902	198	9939100	0.00198	99.38902	pe	vgref	vgref	3
(30,40]	35.5680513801585	61	14636	14575	9953477	259	9953736	0.00259	99.53477	pe	vgref	vgref	3
(20,30]	24.9526250662896	133	11314	11181	9964658	392	9965050	0.00392	99.64658	pe	vgref	vgref	3
(10,20]	16.5452385304332	399	10942	10543	9975201	791	9975992	0.00791	99.75201	pe	vgref	vgref	3
[0,10]	1.99700099966678	8860	24008	15148	9990349	9651	10000000	0.09651	99.90349	pe	vgref	vgref	3
(50,60]	59.9764417223985	214	9694342	9694128	9694128	214	9694342	0.00214	96.94128	se	vgref	vgref	3
(40,50]	45.0523109243697	86	38080	37994	9732122	300	9732422	0.003	97.32122	se	vgref	vgref	3
(30,40]	36.1945534546319	198	50454	50256	9782378	498	9782876	0.00498	97.82378	se	vgref	vgref	3
(20,30]	24.7925509278961	671	54047	53376	9835754	1169	9836923	0.01169	98.35754	se	vgref	vgref	3
(10,20]	15.9588908096332	1711	42229	40518	9876272	2880	9879152	0.0288	98.76272	se	vgref	vgref	3
[0,10]	2.65819045412419	48484	120848	72364	9948636	51364	10000000	0.51364	99.48636	se	vgref	vgref	3
(50,60]	59.9938059440288	129	9925322	9925193	9925193	129	9925322	0.00129	99.25193	pe	vgref	vgref	4
(40,50]	46.4326169038629	69	13772	13703	9938896	198	9939094	0.00198	99.38896	pe	vgref	vgref	4
(30,40]	35.5690079256628	61	14636	14575	9953471	259	9953730	0.00259	99.53471	pe	vgref	vgref	4
(20,30]	24.9526669021547	133	11324	11191	9964662	392	9965054	0.00392	99.64662	pe	vgref	vgref	4
(10,20]	16.5440423976608	399	10944	10545	9975207	791	9975998	0.00791	99.75207	pe	vgref	vgref	4
[0,10]	1.99566702774769	8860	24002	15142	9990349	9651	10000000	0.09651	99.90349	pe	vgref	vgref	4
(50,60]	59.9764417223985	214	9694342	9694128	9694128	214	9694342	0.00214	96.94128	se	vgref	vgref	4
(40,50]	45.0523109243697	86	38080	37994	9732122	300	9732422	0.003	97.32122	se	vgref	vgref	4
(30,40]	36.1945534546319	198	50454	50256	9782378	498	9782876	0.00498	97.82378	se	vgref	vgref	4
(20,30]	24.7925509278961	671	54047	53376	9835754	1169	9836923	0.01169	98.35754	se	vgref	vgref	4
(10,20]	15.9588908096332	1711	42229	40518	9876272	2880	9879152	0.0288	98.76272	se	vgref	vgref	4
[0,10]	2.65819045412419	48484	120848	72364	9948636	51364	10000000	0.51364	99.48636	se	vgref	vgref	4
(50,60]	59.9938007036549	129	9925320	9925191	9925191	129	9925320	0.00129	99.25191	pe	vgref	vgref	5
(40,50]	46.4306442251886	69	13784	13715	9938906	198	9939104	0.00198	99.38906	pe	vgref	vgref	5
(30,40]	35.56916347731	61	14632	14571	9953477	259	9953736	0.00259	99.53477	pe	vgref	vgref	5
(20,30]	24.955845990816	135	11324	11189	9964666	394	9965060	0.00394	99.64666	pe	vgref	vgref	5
(10,20]	16.5466179159049	399	10940	10541	9975207	793	9976000	0.00793	99.75207	pe	vgref	vgref	5
[0,10]	1.99525	8867	24000	15133	9990340	9660	10000000	0.0966	99.9034	pe	vgref	vgref	5
(50,60]	59.9764417223985	214	9694342	9694128	9694128	214	9694342	0.00214	96.94128	se	vgref	vgref	5
(40,50]	45.0523109243697	86	38080	37994	9732122	300	9732422	0.003	97.32122	se	vgref	vgref	5
(30,40]	36.1945534546319	198	50454	50256	9782378	498	9782876	0.00498	97.82378	se	vgref	vgref	5
(20,30]	24.7925509278961	671	54047	53376	9835754	1169	9836923	0.01169	98.35754	se	vgref	vgref	5
(10,20]	15.9588908096332	1711	42229	40518	9876272	2880	9879152	0.0288	98.76272	se	vgref	vgref	5
[0,10]	2.65819045412419	48484	120848	72364	9948636	51364	10000000	0.51364	99.48636	se	vgref	vgref	5
(50,60]	59.9937980978388	129	9925342	9925213	9925213	129	9925342	0.00129	99.25213	pe	vgref	vgref	6
(40,50]	46.4295887225694	69	13762	13693	9938906	198	9939104	0.00198	99.38906	pe	vgref	vgref	6
(30,40]	35.5685605025949	61	14644	14583	9953489	259	9953748	0.00259	99.53489	pe	vgref	vgref	6
(20,30]	24.9513790664781	133	11312	11179	9964668	392	9965060	0.00392	99.64668	pe	vgref	vgref	6
(10,20]	16.5425648520278	400	10948	10548	9975216	792	9976008	0.00792	99.75216	pe	vgref	vgref	6
[0,10]	1.99616538846282	8858	23992	15134	9990350	9650	10000000	0.0965	99.9035	pe	vgref	vgref	6
(50,60]	59.9764417223985	214	9694342	9694128	9694128	214	9694342	0.00214	96.94128	se	vgref	vgref	6
(40,50]	45.0523109243697	86	38080	37994	9732122	300	9732422	0.003	97.32122	se	vgref	vgref	6
(30,40]	36.1945534546319	198	50454	50256	9782378	498	9782876	0.00498	97.82378	se	vgref	vgref	6
(20,30]	24.7925509278961	671	54047	53376	9835754	1169	9836923	0.01169	98.35754	se	vgref	vgref	6
(10,20]	15.9588908096332	1711	42229	40518	9876272	2880	9879152	0.0288	98.76272	se	vgref	vgref	6
[0,10]	2.65819045412419	48484	120848	72364	9948636	51364	10000000	0.51364	99.48636	se	vgref	vgref	6
(50,60]	59.993802110442	131	9925314	9925183	9925183	131	9925314	0.00131	99.25183	pe	vgref	vgref	7
(40,50]	46.4340747201628	69	13758	13689	9938872	200	9939072	0.002	99.38872	pe	vgref	vgref	7
(30,40]	35.569575310665	61	14646	14585	9953457	261	9953718	0.00261	99.53457	pe	vgref	vgref	7
(20,30]	24.9546497264867	135	11334	11199	9964656	396	9965052	0.00396	99.64656	pe	vgref	vgref	7
(10,20]	16.546600877193	399	10944	10545	9975201	795	9975996	0.00795	99.75201	pe	vgref	vgref	7
[0,10]	1.99666722212965	8860	24004	15144	9990345	9655	10000000	0.09655	99.90345	pe	vgref	vgref	7
(50,60]	59.9764417223985	214	9694342	9694128	9694128	214	9694342	0.00214	96.94128	se	vgref	vgref	7
(40,50]	45.0523109243697	86	38080	37994	9732122	300	9732422	0.003	97.32122	se	vgref	vgref	7
(30,40]	36.1945534546319	198	50454	50256	9782378	498	9782876	0.00498	97.82378	se	vgref	vgref	7
(20,30]	24.7925509278961	671	54047	53376	9835754	1169	9836923	0.01169	98.35754	se	vgref	vgref	7
(10,20]	15.9588908096332	1711	42229	40518	9876272	2880	9879152	0.0288	98.76272	se	vgref	vgref	7
[0,10]	2.65819045412419	48484	120848	72364	9948636	51364	10000000	0.51364	99.48636	se	vgref	vgref	7
(50,60]	59.9937992918716	129	9925318	9925189	9925189	129	9925318	0.00129	99.25189	pe	vgref	vgref	8
(40,50]	46.4325344952796	69	13770	13701	9938890	198	9939088	0.00198	99.3889	pe	vgref	vgref	8
(30,40]	35.5684210526316	61	14630	14569	9953459	259	9953718	0.00259	99.53459	pe	vgref	vgref	8
(20,30]	24.9555084745763	133	11328	11195	9964654	392	9965046	0.00392	99.64654	pe	vgref	vgref	8
(10,20]	16.5472491317858	399	10942	10543	9975197	791	9975988	0.00791	99.75197	pe	vgref	vgref	8
[0,10]	1.99608529068799	8871	24012	15141	9990338	9662	10000000	0.09662	99.90338	pe	vgref	vgref	8
(50,60]	59.9764417223985	214	9694342	9694128	9694128	214	9694342	0.00214	96.94128	se	vgref	vgref	8
(40,50]	45.0523109243697	86	38080	37994	9732122	300	9732422	0.003	97.32122	se	vgref	vgref	8
(30,40]	36.1945534546319	198	50454	50256	9782378	498	9782876	0.00498	97.82378	se	vgref	vgref	8
(20,30]	24.7925509278961	671	54047	53376	9835754	1169	9836923	0.01169	98.35754	se	vgref	vgref	8
(10,20]	15.9588908096332	1711	42229	40518	9876272	2880	9879152	0.0288	98.76272	se	vgref	vgref	8
[0,10]	2.65819045412419	48484	120848	72364	9948636	51364	10000000	0.51364	99.48636	se	vgref	vgref	8
(50,60]	59.9937940614984	128	9925332	9925204	9925204	128	9925332	0.00128	99.25204	pe	vgref	vgref	9
(40,50]	46.4317257408483	69	13768	13699	9938903	197	9939100	0.00197	99.38903	pe	vgref	vgref	9
(30,40]	35.5674088239312	62	14642	14580	9953483	259	9953742	0.00259	99.53483	pe	vgref	vgref	9
(20,30]	24.9551078119477	133	11316	11183	9964666	392	9965058	0.00392	99.64666	pe	vgref	vgref	9
(10,20]	16.5408219178082	399	10950	10551	9975217	791	9976008	0.00791	99.75217	pe	vgref	vgref	9
[0,10]	1.99258086028676	8857	23992	15135	9990352	9648	10000000	0.09648	99.90352	pe	vgref	vgref	9
(50,60]	59.9764417223985	214	9694342	9694128	9694128	214	9694342	0.00214	96.94128	se	vgref	vgref	9
(40,50]	45.0523109243697	86	38080	37994	9732122	300	9732422	0.003	97.32122	se	vgref	vgref	9
(30,40]	36.1945534546319	198	50454	50256	9782378	498	9782876	0.00498	97.82378	se	vgref	vgref	9
(20,30]	24.7925509278961	671	54047	53376	9835754	1169	9836923	0.01169	98.35754	se	vgref	vgref	9
(10,20]	15.9588908096332	1711	42229	40518	9876272	2880	9879152	0.0288	98.76272	se	vgref	vgref	9
[0,10]	2.65819045412419	48484	120848	72364	9948636	51364	10000000	0.51364	99.48636	se	vgref	vgref	9
